jai dunlop	jai dumlop	y
lia james	lia jams	y
ashlee morutto	ashlee 	y
lauren pearn	lauren pearn	y
gabrielle schneider	gabrielle schneider	y
flynn sheather	flynn sheather	y
emiily turner	emiily turner	y
hollie miklosi	hollie miklosi	y
gabriella newbown	gabriella newbown	y
kieren bailey	kiereg bailey	y
tony jackson	tony jackson	y
ruby rathjen	rubh rathjen	y
chase jones	chase jones	y
maddison barrell	maddison barrell	y
olivia clemow	olivia clemow	y
kiara lomas	kiara 	y
rohan sims	rohan sims	y
jordan miranda	jordcn miranda	y
patrick smith	patrick smith	y
jessica horgan	jessica horhan	y
alyssa honey	alyssa honey	y
lauren loro	lauren loro	y
meg jarvis	meg jarvis	y
jeremiah perry	jeremiah perry	y
joshua quintal	joshua quintal	y
lauren champion	lauren champion	y
christian nobes	chrisnian nobes	y
michael eyndhoven	michael eyndhoven	y
natalia carn	natalia carn	y
karli fogarty	karli fogarty	y
chelsea brown	chelsea broqn	y
paris kelly	parix kelly	y
taylah manojlovic	taylah manojlovic	y
benjamin regan	benjamin regan	y
joshua weir	joshua weir	y
shane flanigan	shane flanigan	y
joshua eylward	joshua eylward	y
alexander kurtzer	alexander kurtzer	y
cameron smith	cameron smith	y
jayden 	jayden 	y
hayden richards-pugh	hayden richards-pugh	y
dylan lawrence	dylan lawrence	y
kieren watson	kieren watso n	y
stephanie benton	stefanie benton	y
talissa deavin	talissa deavin	y
caitlin cotton	caitlin cotton	y
bailley fuller	bailley fuller	y
nicholas majstorovic	nicholas majstorovic	y
benjamin krujezi	benjamin krujezi	y
antonio hass	antonio hass	y
ellen smith	ellen smith	y
amy savilla	amy savilla	y
samuel schulz	samuel schulz	y
lucas mclean	lucas mclean	y
oakleigh gorrie	oakleigh gorrie	y
madison richards	madison richards	y
stephanie kelly	stephanie kelly	y
kalli bonney	kali bonney	y
henry lawrie	henry lawrie	y
john-paul wyatt	john-paul wyatt	y
alicia gorman	alicia ogorman	y
benjamin spraggs	benjakin spraggs	y
charlotte norman	charlotte normabn	y
mackenzie doyle	mackenzie doyle	y
dante armour	dante armour	y
chloe amos	chloe amos	y
jasmine jones	jasmine jones	y
emiily dogg	emiily dogg	y
ruby 	ruby 	y
elizabeth davis	elizaberh davis	y
jasmine hurrell	jasmine hurrell	y
bertie sundqvist	bertie sundqvist	y
alia hopper	alia hopper	y
isobel scalzi	isobl scalzi	y
ryan walsh	ryan walsh	y
chase taylor	chase taylor	y
 becker	 becker	y
rosie corbett	rosie corbett	y
sophie glover	sophie glover	y
jayden roach	jayden roach	y
adam lakeland	adam lakeland	y
chloe 	chloqe 	y
garth reddington	gart reddington	y
todd young	todd young	y
mackenzie kemish	mackenzie kemish	y
lily nancarrow	lily nancarrow	y
joshua headlam	joshua headlam	y
aidan brandon	aiden brandon	y
james pantelis	james pantwlis	y
erin mcchesney	erin mcchesney	y
jorja mcnicholas	jorja mcnicholas	y
jamie de vries	jamie de vries	y
anastasia jacobsen	anastasia jacobsen	y
ella clark	ella clark	y
madeleine gangell	madeleine gangell	y
jacob cousins	jacob cousins	y
kai lagden	kai lagden	y
benjamin salmon	benjamin salmon	y
angus behr	angus behr	y
thomas nelson	thomas nelwon	y
keeley gow	keeley gow	y
erin lawrence	erin lawrence	y
lynton smith	lynton smith	y
alex mclachlan	alex mclachlan	y
tahlia bonnie	tahlia bonnie	y
rhett chiswell	rhett chiswell	y
william ducker	william ducker	y
philip wang	philip wanng	y
james banks	james banks	y
courtney milisits	courtney milisits	y
mary duncan-lund	mary duncan-lund	y
alessia menzie	alesisa menzie	y
mikayla mccormack	mikayla mccormack	y
emmet musumeci	emmet musumeci	y
luke gouscos	luke gouscos	y
jack farese	jack farese	y
thomas croome	thomav croome	y
emiily ray	emiily ray	y
reuben blackwell	reuben blackwell	y
lauren francis	lauern francis	y
lachlan james	lachlan james	y
elysse herr	elysse herr	y
amy pierce	amy pierce	y
abby cuttriss	abby cuttris	y
jasmine buscombe	jasmine 	y
ethan johnson	ethan johnxon	y
ethan ward	ethan ward	y
hana doyle	hana doyle	y
mia roberts	mia roberts	y
kayden anderson	kayden anderaon	y
maddison lattouf	maddison la ttouf	y
jasmine nicholson	jasmine nicholson	y
ruby dallas	ruby dallas	y
tyler hodge	tylfr hodge	y
skye mcmahon	skye mcmahon	y
kirra heyroth	kirra heyroth	y
sarah pearce	safah pearce	y
harrison christie	harrkson christie	y
cain macbeth	cain macbeth	y
charles lienert	charlex lienert	y
mitchell cho	mitcheol cho	y
morgan johnston	morgan johnston	y
mikayla elphinstone	mikayla elphinstone	y
laura mason	laura mason	y
jayden mollenhof	jayden mollenhof	y
jenna sierat	jenna sierat	y
aleisha massie	aleisha massie	y
desi medhurst	desi medhurst	y
lachlan radford	lachlan radforb	y
nathan tomney	nathan tomney	y
scott flockhart	scott flockohart	y
ellen buckley	ellen buckley	y
sophie goode	sophie goode	y
isabella sturgess	isabella sturgess	y
hayden bird	haydedn bird	y
nellie clark	nelliw clark	y
leah graham	leah grham	y
blakeston fredheim	blakeston fredheim	y
sam woolman	sma woolman	y
darcie anderson	darcze anderson	y
melinda morton	melinda morton	y
alexis payne	alexis payne	y
indiana turner	indiana turner	y
 nichols	 nichols	y
ryley cooper	ryley cooper	y
caleb quigley	caleb quigley	y
tiarna rankine	tiarna rankine	y
sophie hodges	sophie hodges	y
cain taylor	cain taylor	y
emiily gilham	emiily gilham	y
georgia hanna	georgia hanba	y
joel baldwin	jol baldwin	y
oscar griffiths	oscar griffiths	y
alexander kidman	alexander kidman	y
alyssa tucker	alyssa tucker	y
timothy gascoigne	timothy gascoigne	y
michael smith	 smith	y
summer mazeika	summer mazeika	y
 north	 north	y
lara muenster	lara muenster	y
charles peck	charles pekck	y
gabrielle campbell	gabrielle campbell	y
kayla drake-brockman	kayla drake-brockman	y
bryce magro	bryce magro	y
bethany edwards	bethany edwards	y
connor choroszy	connor choroszy	y
nicholas hammat	nicholas hammat	y
luke dingwall	luke dingwall	y
emiily page	emiily pzge	y
isabelle dicks	isabelle dicks	y
ashleigh couzner	ashleigh couzner	y
matilda preiss	matilda preiss	y
matthew cain	matthew cain	y
joel pritchard	joel pritchfrd	y
holly stockman	holly stockman	y
dylan dand	dylan dand	y
william scott	william scott	y
jordan pom	jordan pom	y
hayden newton	hayden newhon	y
courtney edwards	courtney edwards	y
emiily gardner	emiily gardnxer	y
yana cecchin	yana cecchin	y
harrison tooth	harrison tooth	y
georgia henschke	georgia henscjke	y
jakob laycock	jakob laycock	y
tylah kalliontzis	tyah kalliontzis	y
kylee armstrong	kylee armstrong	y
francesco luhrs	francesco luhrs	y
zakariah ayles	zakariah ayles	y
sara-louise mastro	sara-louise matsro	y
talia zeuschner	talia zeuschner	y
jack mcnamee	jack mcnamee	y
tara williams	tara williams	y
matthew pearson	matthew pearson	y
ayla balcomb	ayla balcomb	y
charlotte searson	charlotte searson	y
ashton cheeseman	ashton cheeseman	y
riley williams	riley williams	y
joel masters	joel mastrs	y
riley thumm	riley thumm	y
william olafstottir	william olafstottir	y
jack maynard	jack maynard	y
lachlan smail	lachlan smail	y
jarred ramos-lopes	jarred ramos-lpoes	y
maggie lampe	maggie lampe	y
kaitlin methven	kaitlin methven	y
cameron doherty	cameron doherty	y
jasper kerslake	jasper kerslake	y
benjamin whitehead	benjamin whitehaed	y
james stewart	james stewart	y
richard oke	richard oke	y
caresse sandor	caredse sandor	y
cameron gillespie	cameron gillespie	y
danielle chapman	danieole chapman	y
harrison williams	harriosn williams	y
claire flood	claire flood	y
 hill	 hill	y
baxter kemmery	baxter kemmery	y
connor mutter	connor mutter	y
samuel le messurier	samuel le meyssurier	y
chloe bray	chloe bray	y
oscar langtry	oscar langtry	y
nicholas fogarty	nicholas fofarty	y
samuel lovell	samuel lovel	y
jamilla allen	jamilla allen	y
april kaul	april kaul	y
ruby siebert	ruby siebert	y
nicholas peck	cole peck	y
jayden wood	jayden wood	y
jordan hurst	jordan hurst	y
katie harrisson	katie harriason	y
archie bruno	archie bruno	y
kydan 	kydan 	y
paige antoney	paige antoney	y
chloe murnane	chloe murnane	y
corey wells	corey wells	y
harrison drake	harrison drake	y
alessandria vaughan	alessandria vaughan	y
indiana dimas	indiana dimqs	y
abbey coulter	abbey coulter	y
jackson brackenreg	jackson brackenreg	y
alexa-rose curran	alexa-rose 	y
ella james	ella ames	y
ruby gerlach	ruby gerlach	y
james smith	james smith	y
jake scott	jake scott	y
claire johns	claire johns	y
amy booth	amh booth	y
mikhayla kretschmer	mikhayla kretschmer	y
vanessa 	vanessa 	y
luke parker	luke parker	y
jackson manhood	jacksn manhood	y
zane holden	zane holden	y
liam clarke	liam clark	y
gregory doherty	gregory dohery	y
evan bunney	evan bunney	y
liana chadburn	liana chadburn	y
molly mecklenburgh	molly mecklenburgh	y
felicity bain	felicity bain	y
riley kandadu	riley kandaau	y
robbie carroll	robbie carroll	y
joshua mcpherson	joshua mcpherson	y
lachlan burgess	lachlan burgess	y
emiily thornton	emiily thornton	y
jackson beshay	jackson beshay	y
demie sach	demie sach	y
emiily szentirmay	emiily szentirmay	y
luke brooksby	luke brooksby	y
ellie robinson	ellie robinson	y
dylan pfitzner	dylan pfitzner	y
zack eade	zack eade	y
montana vanderlans	montana vanderlans	y
danielle locke	danielle locke	y
andie shiers	andie shies	y
kayden measday	kayden measday	y
amelia monterola	amelia montefola	y
joshua nichols	joshua nichols	y
taliah trifu	taliah trifu	y
thomas bennetts	tom bennetts	y
stephanie coffey	stephanie coffdy	y
talena cheesman	talena cheesman	y
emiily smith	emiily smith	y
nathan hyde	nathan hyye	y
james furini	james furini	y
alyssa prokopiec	alyssa prokopiec	y
oliver perla	oliver prla	y
jackson bibby	jackson bibby	y
jake linger	jake linger	y
harrison simpson	harrison simpson	y
harrison clark	harrison clark	y
jack norman	jack norkan	y
april broster	april brostery	y
nathan kelly	nathan kelly	y
amy liddel	amt liddel	y
joel johnston	ojel johnston	y
timothy trahair	timothy trahair	y
lucas mcqueen	lucas mcqueen	y
ella beer	ella beer	y
harry macdonald	harry macdonald	y
amelia faunt	ameila faunt	y
finn shipway	finn shipway	y
rhett hansen	rhett hansen	y
madison cummins	madison cummins	y
kye 	kye 	y
edward harrap	edward harrap	y
malakai ikonomou	malakai ikonomou	y
jessica richter	jessica richter	y
benjamin collien	benjamin collien	y
matteus berry	matteus berry	y
brigitte thrussell	brigitte thrussell	y
anthony spear	anthony spear	y
james whitcombe	james whitcombe	y
joshua harris	joshua oharris	y
emiily bielby	emiily bielby	y
harry mckay	harry mckay	y
bianca siely	bianca sieyl	y
erin thomas	erin thomas	y
sybella brennan	sybella brennan	y
zac chippett	zac chippett	y
lucas schrader	lucas schrader	y
larissa thompson	larissa thompson	y
stephanie gifford	stephanie gifford	y
stephanie robinson	stephanie robinson	y
adam rowney	adamo rowney	y
connor wright	connor wright	y
tara broadfield	tara broadfield	y
kelsye bradley	kelslye bradley	y
courtney johansson	courtney johansson	y
harry zanfagna	harry zanfagnf	y
william roeger	willoam roeger	y
jayden heineke	jaden heineke	y
saara tonnies	saara tonnies	y
jordan richards	jordan richards	y
makenzie mansom	makenzie mansom	y
dominic copeland	dominic copeland	y
emiily jamieson	emiiy jamieson	y
dylan parkin	dylan parkkn	y
wil coombe	wil coombe	y
imogen o'reilly	imogen o'reilly	y
thomas kennard	thomas kennard	y
tayah coaldrake	tayah coaldrake	y
jack elix	jack elix	y
jack mullins	jack mullins	y
amelia lahiri	amelia lahiri	y
rhys o'neill	rhys o'neill	y
christopher tregus	christopher tregus	y
dean marshall	daen marshall	y
tiana windram	tiana windram	y
demie drewett	demie drewett	y
georgia steer	georgia steerp	y
hana erkelenz	hana erkelenz	y
samuel south	samuel soith	y
ned burgess	ned burgess	y
mattheo curnow	mattheo curnow	y
abbey zheng	abbey zheng	y
tiarna madson	tiarna madson	y
thomas duke	thomas duke	y
william peters	william peters	y
polly defazio	polly defazo	y
david krzoska	david krzoska	y
alexander browne	alexander browne	y
benjamin robinson	benjamin robinson	y
elizabeth hood	elizabeth hood	y
 muller	 muller	y
sophie stuart	sophie stuart	y
archer farrell	archer farrell	y
daniel walter	daniel walter	y
zack bonney	 bonney	y
kynan hamel	kynzn hamel	y
jack tait	jack tait	y
dylan grapendaal-mawson	dylan grapendaal-mawson	y
danielle davidson	danielle davidon	y
joshua rees	joshua rees	y
jaden shennan	jaden shenn an	y
brooklyn coulson	broolyn coulson	y
destynii farrer	destynii farrer	y
michaela bryant	michaela bryant	y
natalia penfold	natala penfold	y
benjamin vilaythong	benjamin vilaythong	y
phoenix papiccio	phoenix papivcio	y
amelia kies	amela kies	y
sebastian smith	sebastian smith	y
maddison cooper	maddison cooper	y
nicholas wilson	nicholas wilson	y
timothy bonser	timothy bonser	y
brianna spinks	brianna spinks	y
alexander potter	alexander potter	y
eliza gillard	elza gillard	y
caitlin le souef	caitlin le soyef	y
annabel 	annabel 	y
casey harris	caseu harris	y
emiily butler	emiily butler	y
harriet hong	harriet hong	y
imogen pilgrim	imogen pilgrim	y
jacob o'grady	jacob o'grady	y
jake jurecky	jake jurecky	y
tayla ives	tayla ives	y
 christopher	 christopher	y
jaggah newman	jaggah newman	y
deakin bidhendi	deakin bidhendi	y
alice thompson	alice thomspon	y
adam tark	aday tark	y
elizabeth wrede	elizabeth wrere	y
william bergineti	william berginueti	y
joshua frost	joshua frost	y
chloe georgiou	chloe georgiou	y
micaela graham	micaela graham	y
oakleigh coats	oakleigh coats	y
emiily sutherland	emiily sutherlnd	y
timothy rektsinis	timothy rektainis	y
aleisha principe	aleisha princsipe	y
brooklyn finch	brooklyn finch	y
lachlan gillespie	lachlan gillespie	y
harrison batty	harrison batty	y
emma scott	emma scott	y
sylvie manser	sylvie manser	y
stephen o'halloran	stephen o'halloran	y
kiara haggerty	kiara haggerty	y
dylan mugridge	dylan mugridge	y
destynii ahearn	destynii chintamani	y
ella karalis	ella karalis	y
lucas schmidt	lucas schmitdt	y
mitchell fischer	mitchell fischeir	y
jasmine di'lodovico	jasmine di'lodovico	y
jaden beeton	jaden beeton	y
hayden smith	hayden smith	y
matthew dawbarn	matthew dawbarn	y
kaysey nitschmann	kaysey nitschmann	y
jack bowles	jack bowles	y
phoebe robertson	phoebe robertson	y
jessica wheeler	jessica wheeler	y
samuel walker	samie walker	y
eliza riches	eliza riches	y
antonio duregon	antonio duregon	y
joshua chettleburgh	josh chettleburgh	y
liam taute	liam tauge	y
natasha keane	natasha keane	y
shane perrey	shane perrey	y
alexandra baldock	alexandra baldock	y
bridget evans	bridget evans	y
kristin gerhardy	kristin gerhardy	y
daniel white	daniel white	y
sarah vandepeer	sarah vandeeer	y
brianna kennedy	brianna kennedy	y
taylah fuller	taylah fuller	y
bethany ebeling	bethany ebeling	y
fraser lee	fraser lee	y
bailee ryan	bailee ryan	y
carla gillard	carla gillard	y
emiily williams	emiily willims	y
alexandra mills	alexandra mills	y
darcie ramke	darcie ramke	y
connor coleman	connor coleman	y
chelsea richardson	chelsea richarson	y
kade ryan	kade ryan	y
giuliana bastian	giulia na bastian	y
hayden farrell	hayden farrell	y
emiily keitaanpaa	emiily keitaqanpaa	y
bayley cousins	bayley cousins	y
liam olivier	liam olivier	y
annabella perkins	annabella perkins	y
leon beattie	leon beattie	y
sam pearce	sa pearce	y
jacinta vincent	jacinta vinclnt	y
anika brittain	anika brittain	y
victoria shanahan	victoria shanahan	y
sarah thomas	sarah thomas	y
zarlia russell	zarlia russell	y
jessica brown	jessica browtn	y
james gunn	james gunn	y
jessica barry	jessica barrt	y
joel fioretti	joel fioretti	y
alexia bourchier	alexia bourchier	y
william hermsen	william hermsevn	y
oliver denniss	oliver denniss	y
benjamin faludi	benjamin faludi	y
campbell garcia	campbll garcia	y
teagan hawkins	teagan hawkinms	y
emiily 	emiily 	y
thomas easson	thomas easson	y
natalee woehler	natalde woehler	y
isabelle berecz	isabelle berevz	y
matthew austin	matheus austin	y
vianca rawlings	biance rawlings	y
alexander ashby	alexander ashby	y
connor lewis	connor lewis	y
natasha parker	natasha parker	y
braedon dent	braedon deny	y
mia tilbrook	mia tilbrook	y
domenique powell	domexnique powell	y
rourke metzler	rourke metzler	y
caitlin caggiano	caitlin caggiano	y
mia baker	mia baker	y
charlie josephs	charlie josephs	y
patrick doolan	patrick doolan	y
blake mitchell	blake mitchell	y
benjamin coe	bennie coe	y
jake ryan	jake ryan	y
gemaley shannon	gemaley shannon	y
konstantinos orr	konstantinos orr	y
jordan cooper	jordan cooper	y
 dilger	 dilger	y
michael price	michael price	y
lachlan quigley	lachln quigley	y
erin maddocks	erin maddocks	y
jake bishop	jake bishop	y
gregory hill	gregory hill	y
harry 	harry 	y
kyle parkyn	kyle parkyn	y
benjamin winters	benjamin winters	y
april pavic	april pavkc	y
stephanie thorley	stephanie thorley	y
max gardam	max gardam	y
riley sanzo	riley sanzo	y
karissa polley	karissa polley	y
amber rankin	amber rankin	y
lachlan-john dennington	lachlan-john dennnigton	y
jock gill	jock gil	y
kyle maartensz	kyle maatensz	y
lily 	lily 	y
thomas mcphee	thoas mcphee	y
connor vu	connor vu	y
finn milner	finn 	y
ebony crawford	ebony crawford	y
catherine pearce	catherine pearce	y
adam crawley	adam cralwey	y
mia miller	mia miller	y
lewis watt	lewis watt	y
yasmin lees	yasmin lees	y
shane darcy	shane darcy	y
chloe benetts	chloe benetts	y
hayley mirko	hayley mirki	y
meg hughes	meg hughes	y
jade laube	jade laube	y
aikaterina mercer	aikaterina mercer	y
benjamin dimopoulos	benjamin dimoppulos	y
daniel depalma	danny depalma	y
 hawkes	 hawkes	y
lauren farrelly	lauren farrelly	y
daniel lutz	daniel lutz	y
shandril wells	ryan wells	y
william scriven	william scriven	y
lily kibblewhite	lily kibblewhite	y
jenna bird	jenna bird	y
alice quinn	alice quinn	y
jacob hall	jacob hall	y
hannah rockliff	hannah rockliff	y
emiily satalic	emiily satalic	y
jack snoswell	jack snoswell	y
eliza o'connell	eliza o'connell	y
zack fischer	zack fischer	y
isabella donald	isabella donald	y
rosie thon	rosie thon	y
jeremy oakes	jerome oakes	y
bailey leslie	bailey leslie	y
michael guest	michael giest	y
harry urbancic	harry urbancic	y
dakota robinson	dakotz robinson	y
danielle kontos	danielle kontos	y
michael 	michael 	y
chelsea ford	chelsea ford	y
connor buttigieg	connor buttigieg	y
olivia erichsen	olivxa erichsen	y
noah conway	noah conway	y
laura limb	laura limb	y
jemma wilcox	jemma wilcox	y
sarah schuster	sarh schuster	y
joshua jones	joshua jones	y
jack lelos	 lelos	y
melanie jones	melanie jones	y
zarran caulfield	zarraq caulfield	y
jayme brind	jayme brind	y
teileah chapman	teileah chapman	y
sophie bampton	sophie bampton	y
jamilla black	jamilla blacj	y
madeleine ngai	madeleine ngji	y
alana uebel	alana uebeo	y
joe plew	joe plew	y
riley humeniuk	riley humeniuk	y
dale napper	dale napper	y
libby el houssami	libby el houssami	y
ryan battisson	ryan battisson	y
keelin foley	keelin fole y	y
angie barnett	angie barnett	y
zali lucas	zali lucas	y
gabriel connolly	gabriel connolly	y
matthew griffiths	matthew griffiths	y
james azmarli	james azmarrli	y
joshua elmer	joshua elmer	y
jordyn peake	jordyn peake	y
henry gallo	henry gallo	y
taylah prior	taylah prior	y
larissa brooks	larissa brooks	y
kyle horsphol	kyle horsphol	y
isabella goleby	isabella goleby	y
ryan thurstans	ryan thurstans	y
aaliyah butwell	aaliyah butwell	y
nikita everett	nikita everett	y
jake browne	jake browge	y
jayden pupi	jayden pupi	y
imogen partridge	imogen partridge	y
samantha jeng	samantha jeng	y
alexander edwards	alexander edwards	y
sarah skillitzi	sarah skillitzi	y
harrison mcculloch	harrisob mcculloch	y
lara holland	lara holland	y
emiily borrillo	emiily borrillo	y
jack tiller	jack tiller	y
ewan bach	ewan bcah	y
jordan highet	jordan highet	y
amber ah chee	amber ah chee	y
cameron haynes	cameron haynds	y
aleisha tucker	aleisha tucker	y
isabel elliott	isabel elliott	y
ryan hehir	ryan hehir	y
oscar lim	oscar lim	y
emiily kaye	emiily kaye	y
madison appleby	madison appleby	y
emma fisher	emma fisher	y
anthony zhou	anthony zhou	y
mikayla martin	mikayla martin	y
william hunt	william hunt	y
katie fischer	katie fiacher	y
tyler dale	tyler dale	y
ruby hatfield	ruby hatfield	y
kate altman	kate altman	y
harrison loechel	harrison loechel	y
jenna rapo	jenna rapo	y
gianni ingram	gianni ingram	y
sonja nelson	sonja nelson	y
ethan jones	ethan jones	y
lucy bache	lucie bache	y
riley golledge	riley golldge	y
isabella williams	isabella williams	y
isabella sie	isabella se	y
hattie marsland	hattie marsland	y
ashleigh abbattista	ashleigh abbattista	y
 mcphee	 mcphee	y
chloe mizzen	chloe mizzen	y
ashton scales	ashton scales	y
james gifford	james gifford	y
caleb murray	caleb murray	y
caleb corcoran	caleb corcoran	y
bailee fern	bailee fenn	y
abby barnard	abby barnard	y
jesse trebilcock	jesse trebilcock	y
phoebe mundy	phoebd mundy	y
samuel hayward	samuel hayward	y
kailey mckenzie	kailey mckenzie	y
zali scott-palframan	zali scott-palframan	y
riley graham	riley graham	y
ryley dragan	ryley dragan	y
isabella martin	isabella martin	y
hannah hammond	hannah hammond	y
pakita smith	pakits smith	y
april radford	april radford	y
emiily hollis	emiily hollis	y
mattheo gray	mattheo gray	y
hamish buntine	hamihh buntine	y
dylan woodley	dylan woodley	y
tara schroeder	tara schroeder	y
holly hansen	holly hansen	y
zane dixon	zane dixon	y
maddison smith	maddison smith	y
emiily richardson	emiily richardson	y
domenique 	domenique 	y
william evans	william evajs	y
michael schober	michael schober	y
michael luckraft	michsel luckraft	y
sophie corey	sophie corey	y
monique coates	monique coates	y
stephanie simkin	stephanie simkin	y
lewis howell	lewis howell	y
william gottwald	william gottwjld	y
zakariah mcgarrity	zakariah mcgarrity	y
shelby prince	shelby prinxe	y
dante oats	dante oats	y
dylan stahl	dylan stahl	y
henry bentley	harry bentley	y
anthony gerblich	anthony gerblich	y
liam lu	liam lu	y
hattie cottrell	hattie cottrell	y
sophie hall	sophie hall	y
pino smith	april smith	y
adam billington	adam billington	y
jye radic	jye radic	y
diamond dobie	diamond dobie	y
amelia strudwick	amelia strunwick	y
mia noonan	mia noonan	y
georgia rebuli	georgia rebuli	y
jye olsen	jye olsen	y
mackenzi walsh	mackebzi walsh	y
karli burden	karli burden	y
mikhayla lewis	mikhafla lewis	y
talia pike	talia pike	y
holly wight	holly wight	y
tiffany woodward	tiffany woodward	y
jessica morgan	jessica morgan	y
joel crossman	joel crossman	y
caleb saab	cale b saab	y
georgia warburton	georgia warburton	y
caitlin cheesman	caitlin cheesman	y
jett simpfendorfer	jett simpfendorfer	y
jordan cotterill	jordyn cotterill	y
imogen pollard	imogen pollaed	y
cameron de bruin	camern de bruin	y
jye moss	jye moss	y
karlee gilligan	karlee gilligan	y
liam granquist	liam granquist	y
tarnee ford	tarnee forvd	y
daen thomas	daen thomas	y
daniel cirillo	daniel cirillo	y
matthew ford	matthew faord	y
elisha parkins	elisah parkins	y
drew cross	drew cross	y
adela cowley	adela cowley	y
alissa smart	alissa smart	y
jye turner	jyeq turner	y
travis anderson	travis anderson	y
nasyah haward	nasyah haward	y
mitchell watson	mitchell watson	y
kelsye datta	jonah datta	y
madeline claridge-robins	madeline claridge-robins	y
holly dutton	holly finlay	y
harrison hartshorne	harrison hartshorne	y
jack mcdonough	jack mcdpnough	y
harvey bailey	harvey bailey	y
joel smythe	joel smythe	y
amelia somerville	amelia somerville	y
miller galeff	miller galefj	y
ethan mcguinness	ethan mcguinness	y
jack vassallo	jack vassalko	y
hayden yeaman	hayden yeaman	y
brydon cutler	brydon cutler	y
lachlan howell	lachlan howell	y
william parsons	william parsons	y
 mouratou	 mouratou	y
kyle dodds	kyle dodds	y
brianna 	brianna 	y
laetitia forward	laetitia forward	y
patrick bolton	patrick bolton	y
thomas mcmahon	thomas mcmahon	y
noah reid	noah reid	y
sara desouza	sara desouza	y
daniel robinson	daniel robinson	y
charlize downey	charlize downey	y
joshua peebles	joshua peebles	y
daniel evans	daniel evans	y
charlie perri	charlie perri	y
harry schrader	harry schrader	y
mikhayla majhrovski	mikhayla majhrovski	y
benjamin arbon	benjamin arbon	y
fynn lewis	fynn lewis	y
kane frears	kane frears	y
mackinley wesseling	mackinley wesseling	y
toby smith	toby smith	y
madison jacobs	madison jacobs	y
gemma kolencik	gemma kolencik	y
jessica o'toole	jessica o'tooke	y
lauren bowman	lauren bowman	y
alessandra cattel	alessandra cattel	y
patrick crawford	patrick crawford	y
keaton tanner	keaton tanner	y
lily blackwell	lil blackwell	y
jesse dallacqua	jesse dallacqua	y
melanie klimeck	melanie klimeck	y
 mazzarolo	 mazzarlo	y
william rabe	william rabe	y
joel richards	joel richtrds	y
jayde miller	jayde miller	y
liam girdler	liam girdler	y
hayden bennett	hayden bennett	y
joshua robertson	joshua robertson	y
thomas o'toole	thomas o'toole	y
andrew harrex	andrew harrex	y
emma davis	emmw davis	y
kimberly modra	kimberly modra	y
jaden sutton	jaden sutton	y
 franklin	 franklin	y
alia bailey	ala bailey	y
tarnia unger	tarnia unger	y
matthew jackson	mat jackson	y
campbell jovanovic	cambell jovanovic	y
jack abbott	jack abbott	y
roy clark	roy clark	y
brianna hinton	brianna hinton	y
nacoya ali	nacoya ali	y
alexandra calvert	alexandra calvert	y
madalyn kelsh	madalyn kepsh	y
ruby bradshaw	ruby bradshaw	y
natalia mourant	natalia mourant	y
aneka dixon	aneka dixon	y
jasmine brandt-wilson	jasmine brandt-wilson	y
 keraitis	 keraitis	y
georgia bremer	georgia bremer	y
chloe bolian	chloe bolian	y
kyra mcmahon	kyra mcmahon	y
meggie parker	meggie parker	y
jacob 	jacob 	y
jacqueline 	jacqueline 	y
aurora van	aurora van	y
zoe yates	zoe dudgeon	y
jessica aitchison	jessica aitchison	y
lewis smith	lewis smith	y
jordan gras	jordan gras	y
katelyn 	katelyn 	y
oakleigh yaxley	oakleigh yaxley	y
joshua jones	joshua jones	y
georgia proud	georgia projd	y
riley harman	ryley harman	y
thomas naidu	thomas naidu	y
grace mutton	grace mutton	y
kane wilson	kane wilson	y
toby starks	toby starks	y
lacey 	lacey 	y
alexander gough	alexander gough	y
sara yiannakos	sars yiannakos	y
sophie tiggeman	sophie tiggeman	y
jed saunders	jed saunders	y
samantha sexton	samantha sexton	y
david kahl	david kahl	y
sean 	sean 	y
brodee barron	brodee barron	y
emiily van der linden	emiily van der linden	y
brooklyn emmerson	brookyln emmerson	y
andrew thompson	andrew thompson	y
karli megaw	karli megaw	y
joel amos	joel amos	y
emiily lear	emiily leaqr	y
yasmin miller	yasmin millef	y
emerson wraight	emerson wraitht	y
bailley ram	bailley ram	y
ruby sitkowski	ruby sitkowski	y
georgia harrison	georgia harrison	y
adele hutchings	adele hutchings	y
william bresnehan	william 	y
kirrah mayfield	kirrah mayfield	y
april praznak	april praznak	y
kira greenberg	kira greenberg	y
amber 	amber 	y
jennifer roney	jennifer roney	y
ruben graccogna	ruben gracogna	y
charlotte walker	charlotte walker	y
sybella richards	sybella richards	y
hayley sheppard	hayley sheppard	y
liam kojcic	liam kojcic	y
ruby wilson	ruby wilson	y
cheree denny	cheree denny	y
lachlan bailey	lachlan bailey	y
mitchell gohl	mitchell 	y
kayden cornish	kayden cornish	y
belinda day	belinda dat	y
jack sladden	jack sladden	y
william bobstchlinski	willoam bobstchlinski	y
matilda hinds	matilda hinds	y
kelsea barber	kelsea barber	y
ky raff	ky raff	y
charles churchill	charles churchill	y
katelyn tregoning	katelyn tregoning	y
lia peek	lia peek	y
carlin joyes	carlin joyes	y
michael gillon	michael gillon	y
lukas mcgregor	lukas mcgregor	y
elisha wattam	elisha wattam	y
hannah ottey	hannah ottey	y
alex hrstic	alex hrstic	y
joshua coleman	joshua coleman	y
 trott	 trott	y
jade paroissien	jade paroissien	y
caitlin shilton	caitlin shilton	y
zoe poels	zoe poels	y
meg sciancalepore	meg sciancalepore	y
joel brown	joel brown	y
emma hall	emma haln	y
 farrington	 farrington	y
charlie roddie	charlie roddie	y
ruby allen	ruby large	y
tara hudson	tara hudson	y
emiily ferguson	emiily ferguson	y
connor renton	connor renton	y
kelsea roberts	kelsea robdrts	y
dylan morgan	dyban morgan	y
naomi harvey	naomi harvey	y
joshua lomman	joshua lomman	y
james stuart	james stuart	y
zachary waite	zachary waite	y
kaitlin deakes	kaitlin deakes	y
hayley hearn	hayley hearn	y
luke powardy	luke powardy	y
cassandra halliday	cassandra halliday	y
lily chen	lily chen	y
oscar harrison	oscar harrkson	y
oscar arrowsmith	oscar arrowsmith	y
grace scharf	grace scharf	y
peyton eggerking	peyto eggerking	y
pino white	pino white	y
taalia lehman	tajalia lehman	y
hannah webber	hannah webber	y
joel cornwall	joel cornwall	y
jack claridge	jack claridge	y
cameron 	cameron 	y
alexandra o'connor	alexandra o'connor	y
bridget thompson	bridget thompson	y
andie khan	andie khan	y
hayden keeler	hayden keeler	y
william woolford	willy woolford	y
lani bath	lani bath	y
jacob armstrong	jacob armstrong	y
dylan pendlebury	dylan pendlebury	y
aidan bridgland	aidan bridglsnd	y
izaac stanbury	izaax stanbury	y
bailee lowe	bailee lowe	y
cameron 	cameron 	y
phoenix hall	phoenix hall	y
connor neal	connor neal	y
jack cavanagh	jacj cavanagh	y
jemma dew	jemma dew	y
lily turner	lily turner	y
jordan amagula	jordan amagula	y
riley riches	riley riches	y
megan blackwell	megan blackwell	y
lushia barnes	lushia barnes	y
imogen gormly	imogen gormly	y
jessica attard	jessica attsard	y
ryan size	ryan sizd	y
kaitlin hille	kaitlin hille	y
kyle horsburgh	kyle horsburgh	y
william cilfone	william cilfone	y
harrison gemmell	harrion gemmell	y
clement yates	clement yates	y
trent mccarthy	trent mccarthy	y
kallie murphy	kallie murphy	y
william hill	william hill	y
arren lynch	arren lynch	y
 lock	 lock	y
brock harrison	brock harruson	y
emiily payne	emiily payne	y
isabella penn	isabella penn	y
bailey symons	bailey symons	y
james leong	james leong	y
esther rogers	esther rogers	y
christopher alpike	christopher alpike	y
oliver roach	oliver riley	y
samantha shepard	samantha shepard	y
elly tully	elly tully	y
joel gillam	joel gillam	y
byron hood	byron hood	y
saara hoffman	saara hoffman	y
zack harding	zazk harding	y
stella smallman	stella smallnan	y
pakita duggie	pakits duggie	y
chelsea glover	chelsie glover	y
shandril downie	shandril downie	y
georgia biezantes	georgia biezantses	y
rourke mclean	rourke mclean	y
cameron farguna	cameron farguna	y
jessica allen	jessica allen	y
casey petrov	casey petrov	y
kathleen melville	kathleen melville	y
harrison o'connell	harrison o'connell	y
alexander cleveland	alexander cleveland	y
mia stewart	mia stewart	y
pascale taylor	pascal taylor	y
lachlan drury	lachlan drury	y
mitchell bain	mitchell bain	y
emiily kirchner	emiily kirchner	y
lachlan collins	lachlan collins	y
angus dawson	angus dawson	y
teaha grimshaw	teaha grimshaw	y
ethan wright	ethan wright	y
katelyn harper	katelyn harper	y
hayley dunlop	haylee dunlop	y
patrick schwarz	patrick schwarz	y
millane browne	millane browne	y
samuel vlachoulis	samuel vlachoulis	y
tiffany merrick	tiff merrick	y
jessica catton	jessica catton	y
caleb vlaanderen	caleb vlaanderen	y
hannah wachtel	juliana wachtel	y
jessica flounders	jessica flounders	y
sarah stephens	sarah stephens	y
ellen white	ellen wight	y
cooper white	coopee white	y
jeremy jericho	jeremy jericho	y
phoebe paul	phoebe paul	y
joshua fekete	joshua fekee	y
taylor rowe	taylor rowe	y
mitchell edwards	mitchell edwardys	y
leo barwick	leo barwick	y
toby taliangis	toby taliangis	y
jasmine macko	jasmine macko	y
zachary watson	zachary watson	y
peter ingles	peter ingles	y
kane timbs	kane timbs	y
lachlan mckenzie	lachlan mckenzie	y
tara harvey	tara harvey	y
timothy tate	tigothy tate	y
joshua miceli	joshua miceli	y
kirra collier	kirra collier	y
james rowland	james rowland	y
erin byers	eein byers	y
jackson prestwich	jackson prestwich	y
kai pringle	kai pringle	y
luke boskell	luke boskell	y
travis parish	travis parish	y
ethan baker	ethan baker	y
jake eastoe	jake eastoe	y
ethan rusalen	ethan rusalen	y
koula beckett	koula bekcett	y
alec hill	alce hill	y
harrison tibbits	harrison tibbits	y
kirra siberry	kirra sibeery	y
alexander kennewell	alexanser kennewell	y
lauren brattoli	lauren brattoli	y
nicholas vout	nicholas vout	y
connor chapman	connor chapman	y
lachlan harris	lachlan harrsi	y
emiily tso	emiily tso	y
emma bulters	emma bulters	y
mikaela van emmerik	mikaela van emmerik	y
joshua lindo	joshua lindso	y
finlay stephenson	finley stephenson	y
samuel steel	samuel steel	y
ruby segneri	ruby segneri	y
jack pfeiffer	jack pfeiffer	y
joshua geister	joshua geister	y
sophie guy	sophie guy	y
wade mobbs	wade mobbs	y
kayla gearman	kayla gearman	y
marcus fischer	marcus fischer	y
joshua miller	joshuz miller	y
lucy hywood	lucy hywood	y
jordan taddeo	jordad taddeo	y
benjamin taylor	benjamin taylpor	y
simon buric	simon buric	y
 dotto	 dotto	y
david tyrrell	david tyrrell	y
mila millward	mila millward	y
samuel rowe	samuel rore	y
ryan o'connor	ryan o'connor	y
 briston	 briston	y
hannah corbell	hannah corbell	y
ruben hobbs	ruben hobbs	y
madison cook	madison cook	y
joshua smith	joshua smith	y
luke edgcumbe	luke edgcumbe	y
shelby wood	shelby wood	y
joanna armenio	joanna armenio	y
elly sculthorpe	elly sculthorpe	y
charlotte denley	charlotte denley	y
spencer duggan	spencer duggan	y
kaitlyn peters	kaitlyn peters	y
aaron walsh	aaron walsh	y
hayley o'loughlin	hayley o'loughlun	y
jinni gardner	jinni gardner	y
isabella ganser	isabella ganser	y
teileah nickson	teileah nickson	y
liam nikas	liam nizas	y
isabella mountain	isabella mountain	y
matthew cruise	matthew cruise	y
adam dewart	adam dewart	y
hayden douglass	hayden douglass	y
christian henderson-smith	christian henderson-smith	y
emiily aitchison	emiily aitchison	y
james elphinstone	james elphinstone	y
oliver rubens	ollie rubens	y
mark brown	mark brown	y
stephanie witt	stephanie witt	y
rachel morrow	rachel morrow	y
jason colbeck	jason colbeck	y
montana randell	montana randell	y
jemma whitney	jemma whitney	y
ruby byatt	ruby byatt	y
nicholas caruso	nicholas caruso	y
ruben richter	ruben richter	y
jayden hay	jayden hay	y
finley mayne	finley mayne	y
bethanie burgess	bethanie burgess	y
benjamin smark	benjamin smark	y
deakin ewington	deakin ewington	y
michael marks	michael marks	y
luke jennings	luke jennings	y
john brady	john brady	y
matthew white	matthew white	y
kailey warner	kaley warner	y
luke good	luke good	y
jye faulkner	jye faulner	y
jarod chilcott	jarod chilcott	y
mikayla hogg	mikayla hogg	y
samuel mcpherson	samuel mcpherson	y
christian kenny	 kenny	y
olivia martin	olivia martin	y
ethan baker	ethan baier	y
jade boon	jade boon	y
alexander holland	alexander holland	y
jade cass	jade cass	y
nicholas macintosh	nicholas macintosh	y
hayden dickens	hayden dickens	y
ayla barwick	ayla barwick	y
james hart	james harn	y
tabitha bristow	tabitha bristow	y
zoe king	zoe king	y
isabella richards	isabella richards	y
chelsea lanham	chelsea lanham	y
riley evans	riley evans	y
jack dimcev	jak dimcev	y
isabella colquhoun	isabella colquhoun	y
genevieve fergusson	genevieve ferhusson	y
olivia tham	olivia tham	y
elly mccarthy	ellu mccarthy	y
tyler leighton	tyler leighotn	y
neneh harris	neneg harris	y
kaitlin blesing	kaitlin blesing	y
alexander shelton	alexander shelton	y
angelina christie	angelina christie	y
tansy modra	tansy modra	y
riley pereira	riley pereira	y
lily nguyen	lily nguyen	y
connor thompson	connor thompon	y
tahlia thomas	tahlia thomas	y
emiily cox	emiily cox	y
olivia wait	olivia wait	y
izaac tsoukalas	izaac tsoukalas	y
tate sacoutis	tate sacoutis	y
james march	jim march	y
jayden britton	jayden britton	y
rachael pretty	rachael pretty	y
hannah bell	hannah bell	y
maya swain	maya swain	y
jayden bligh	jayden bligh	y
nicholas daw	nicholas daw	y
mackenzie jones	mackenzie jones	y
lachlan bage	lachlan bage	y
joel pascoe	joel pascoe	y
taylah wilmott	taylah wilmott	y
fergus murray	fergus murray	y
mackinley mcneill	mackinley mcneill	y
caleb davis	caleb davis	y
schkirra weger	schkirra weger	y
rory evans	rory evans	y
emiily eddington	 eddington	y
dylan crosby	dylan crosby	y
cooper hamlyn	cooper hamlyn	y
anika hughes	anika hughes	y
benjamin keymer	benjamin keymer	y
wilson williamson	wilson williamson	y
connor staltari	connor staltari	y
annabel pattison	annabel pattimon	y
sonja kalamitis	sonja kalamitis	y
brinley mitchell	brinley mitchell	y
charlotte bowden	charlotte bowden	y
stephen gridley	stephen gridley	y
samuel nist	samuel nist	y
erin berjak	erin berjak	y
abbey izzo	abbey izzo	y
noah parsons	noah parsons	y
mia vostatek	mia vostatek	y
 rice	 rice	y
abby plakalovic	abby plakalovic	y
hamish rana	hamish rana	y
sophie miles	sopjie miles	y
imogen martin	imogen martin	y
 axam	 axam	y
jayden edwards	jayden 	y
jessica taylor	jessica taylof	y
liam cooke	liam cooke	y
chloe leane	chloe leane	y
teneille soar	teneille soar	y
ashlee ludas	ashlee ludas	y
toby kennett	toby kennett	y
zali mcculloch	zali mcculloch	y
sonja mettananda	sonja mettananda	y
zachary richter	zachary richtef	y
beth parham	beth parham	y
sarah hynes	sarah hynes	y
ellen conley	ellen conley	y
zali maguire	zali maguire	y
matthew graham	matthew graham	y
amaya stanley	amaya stanley	y
tara gulliver	tara gulliiver	y
tony carter	tony carter	y
felicity wilson	felicia wilson	y
eleni climie	eleni climie	y
isabella lauck	isabella lauck	y
joshua simon	joshua simon	y
mitchell gromadzki	mitchell gromadzki	y
ben richards	ben richards	y
rupert lovell	rupert lovall	y
nathan bashir	nathan bashir	y
benjamin simpson	benjamin simpson	y
alisha cummings	alisha cummings	y
timothy 	timothy 	y
isabelle dyer	isabelle dyef	y
abbey catchpoole	abbey catchpiole	y
talia smith	talia smith	y
trinity collis	trinity collis	y
 bishop	 bishop	y
holly ansell	holly ansell	y
kirra hallam	kirra hallam	y
isabella bogacz	isabella bogacz	y
ethan marshall	ethan marshall	y
braedon scammell	braedon scammell	y
liam gibson	liam gibson	y
koben turner	koben turner	y
daniel abbott	daniel abbott	y
matthew moore	matthew moorem	y
ella jackson	ella jackson	y
henry wong	henry wong	y
louise barnes	louise barnes	y
amber paynter	amber paynter	y
georgia sumner	georgia sumner	y
benjamin cooper	benjamin cooper	y
liam heffernan	liam heffernan	y
neve boase	nev boase	y
max dunnings	mxa dunnings	y
cameron davey	cameron davey	y
connor ransley	connor ransley	y
lauren pitt	lauren pitt	y
carlin graham	carlin graham	y
ellouise clarke	ellouise clarke	y
travis goodin	travis goodin	y
ellie liccione	ellie liccione	y
robert bishop	robert bishop	y
cooper laver	cooper laver	y
giuliana murdocco	giuliana murdocco	y
finn mott	finng mott	y
hayley simons	hayley simond	y
jye brown	jye brown	y
lilly allen	lilly allen	y
shaun archer	shaun archer	y
sara-louise holmes	sara-louise holmes	y
indiana lewis	indiana lewws	y
drew armitage	drew armitage	y
amelia warren	amelia warrn	y
emiily lowe	emiily lowe	y
sophie larner	sophie larner	y
jessica kay	jessica kah	y
finn sheehan	finn sheehan	y
ebony pedler	ebony pedler	y
hari murfett	hari murfeft	y
keira stevens	keira stevens	y
emiily strong	emiilu strong	y
hayden raedt	hayden raedt	y
 smith	 smith	y
sophie starr	sophie starr	y
amber hanson	amver hanson	y
braedon 	braedon 	y
caitlin callison	caitlin callison	y
makayla selfe	makayla selfe	y
jackson reynolds	jackson reynolds	y
kaela brereton	kaela brereton	y
emiily lee	emiily lee	y
darcy fenner	darcy fenner	y
harrison sneath	harrison sneath	y
emiily bishop	emiily bishop	y
adam steinberner	adam steinberner	y
jackson luttrell	jackson luttrell	y
sarah schultz	sara schultz	y
gillian taylor	gillian taylor	y
kane eadie	kane eadie	y
jayden murray	jayden murray	y
ryan head	ryan head	y
jed thomas	jed thomas	y
angelina smith	angelina smith	y
alexandra james	alexandra james	y
esme whitehead	esme whitehead	y
julia beyer	julia beyer	y
ella phillips	ella phillips	y
joselyn kraft	joselyn kraft	y
sophie page	sophie page	y
alisa hannam	alisa hannsm	y
tara swails	tara swails	y
phillip wilson	phillip wilson	y
john gauci	john gauci	y
noah childs	noah childs	y
david atyeo	dagid atyeo	y
james todd	james todd	y
tayla ward	tayla ward	y
 cross	 cross	y
jacob richards	jacob richards	y
connor dowie	connor dowie	y
nicholas paul	nichllas paul	y
rhiannon masterton	rhiannon masterton	y
archer moseley	archer moseley	y
annabel lill	annabel lill	y
harley talbot	harley talbot	y
liam salter	liam salter	y
ysobel irving	ysobel irving	y
reganne daniel	reganne daniel	y
bailey haskett	bailey haskett	y
ashleigh boyt-cullis	ashleigh boyt-cullis	y
juliana sutton	juliana sutton	y
lewis boffo	lodovico boffo	y
jack holly	jack holly	y
riley horswell	connor horswell	y
nemesia francis	nemesia francis	y
benjamin collet	benjamin collet	y
ben schultz	benw schultz	y
connor hornby	connor hornby	y
cooper grist	benjamin grist	y
matthew game	matthew game	y
hannah costelloe	hannah costelloe	y
alicia downie	alicia downi	y
maya pinder	maya pinder	y
ned thomas	ned thomas	y
nicholas miller	nicholas miller	y
samuel haugland	samuel haugland	y
jessica mcphee	jessica mcphee	y
wilson burgess	wilson burgess	y
daniel gamlin	daniel gamlin	y
brooke fielding	brooke fielding	y
sarah rodda	saara rodda	y
shelby talanskas	shelb talanskas	y
emiily curr	emiily curr	y
gemma bliss	gemma bliss	y
jenna roberts	jenna roberts	y
georgia johnson	georgina johnson	y
chloe brown	chloe brown	y
connor muscat	connor muscat	y
william fuller	william fuller	y
imogen henry	imogen henry	y
jake middleton	jake middleton	y
mikhaili allen	mikhaili allen	y
courtney underwood	courtney underwood	y
quinn james	quinn jamesr	y
jacob ledgard	jacob ledgard	y
kyle scrima	kyle scrima	y
brinley o'loughlin	brinley o'loughlin	y
henry mavi	henry mavi	y
jemma dyrynda	jemma dyrynda	y
brianna belgrove	briana belgrove	y
holly scheucher	holly scheucher	y
harley cox	harley co	y
holly sloan	holly sloan	y
rhys 	rhys 	y
joshua palm	joshua palm	y
zachary rowley	zachary rowlxey	y
lauren turnbull	lauren turnbull	y
gianni saul	gianni saul	y
michael agapito	michael agapito	y
tiana sargent	tiana sargent	y
juliana nancarrow	juliana nancarrow	y
wade morgan	wade morgan	y
samantha lancaster	samantha lancaster	y
isabella raymond	isabella raymond	y
dylan champion	dylan champion	y
madeleine betts	madeleine betts	y
james robertson	james robertson	y
caitlin denehey	caitlib denehey	y
rosa hawke	rosa hawke	y
liam andrew	lkam andrew	y
marcus zanin	marcuas zanin	y
melinda rodot	melimnda rodot	y
mya lewis	mya lewis	y
matthew blackberry	matthew blackberry	y
isabelle levison	isabelle levison	y
luke johns	luke johns	y
kelsy jacobson	kelsy jacobsom	y
hugh canning	hugh canning	y
lachlan fletcher-jones	lachjlan fletcher-jones	y
zoe dean	zoe dean	y
rebecca lillie	rebecca lillie	y
samuel triffett	samuel triffett	y
gabrielle carlino	gabrielle carlino	y
kylee rowston	kylee rowston	y
dominic harding	dominuc harding	y
sophie anderson	sophie anderson	y
jayden grace	jaydeb grace	y
zac whittington	zac whittington	y
latham bartley-steele	latham bartley-steele	y
madeleine smith	madeleine smith	y
lewis morris	lewis morris	y
 shoumack	 shoumack	y
georgia chenoweth	georgia chenoweth	y
erin o'leary	erin o'leary	y
emma saunders	emma saunders	y
cassandra steel	cassandra steel	y
joel goddard	joel goddard	y
prudence van vliet	prudence van vliet	y
kyle jericho	kyle jerichl	y
eden langley	eden langley	y
helena jacobs	helena jacobs	y
shannon davies	shannon davies	y
luke vater	luek vater	y
daniel self	dajiel self	y
aiden gerblich	aiden gerblich	y
isabelle barry	isabelle barry	y
tylah saxon	tylah saxon	y
ellie lewis	ellie lewis	y
daniel pilkington	daniel pilkington	y
sam dinan	sam dinan	y
holly goodman	holly goomdan	y
arren robertson	areen robertson	y
jacob donaldson	jacob donakdson	y
james simpson	james simpson	y
harry pennifold	daniel pennifold	y
zachary todino	zachwry todino	y
owen rood	owen rold	y
anneliese field	anneliese field	y
sebastian dundas	sebastian dundas	y
lachlan molchanoff	lachlan molchanoff	y
ryleh everett	ryleh everett	y
charlotte bradley	charlotte bradley	y
james heald	giuseppi heald	y
alex lucks	alex lucks	y
isabella carter	isabella carter	y
 	 	y
ebony bartlett	ebony bartltt	y
dillon strauss	dillon strauss	y
molly saleem	molly saleek	y
leo holmes	leo holms	y
calvin stephens	calvin stephens	y
william kennedy	william kennedy	y
ashleigh schrapel	ashlrigh schrapel	y
makayla capaldo	makayla capaldo	y
riley strano	riley strpano	y
larissa burleigh	larissa burleigh	y
katherine bowern	katherine bowern	y
james carpenter	james carpenter	y
sophie altschwager	sophie altschwager	y
talan perry	talan perry	y
emiily paynter	emiily payntwr	y
mitchell arnott	mitchell arnott	y
shenae crook	shenae crook	y
katelyn harding	katelyn harding	y
tiarna redden	tiarna redden	y
amber hercock	amber hercock	y
emerson levi	emerson levi	y
jessica goold	jessica goold	y
mitchell parnell	mitchell parnekl	y
warrick wojcik	warrick wojcik	y
noah bruce	noah kent	y
bailey scarlett	bailley scarlett	y
lily jose	lily josep	y
 sherman	 sherman	y
maya gatenby	myaa gatenby	y
mikayla fuller	mikyla fuller	y
schkirra oprean	schkirra oprean	y
lucas williamson	lucas williamson	y
jayden mundy	jayden mundy	y
kallie devlin	kallie devlin	y
alessandra jones	alessandra jones	y
ava oberthur	ava oberthur	y
shelby tuttle	shelbey tuttle	y
talena fox	talena fox	y
hannah ciolek	hannah ciolek	y
lucy fidler	lucy fidler	y
finlay lightfoot	finlay lightfoot	y
danny schultz	danny schultz	y
jakob petersen	jakob petersen	y
madeline freeman	madeline freeman	y
james berry	james berry	y
hari corney	hari corney	y
meg goussios	meg goussios	y
bree goreham	bree gorehm	y
connor bennett	connof bennett	y
alex dehn	alex dehn	y
samantha 	samantha 	y
hayley barker-hudson	hayley barker-hudson	y
holly crisford	holly crisford	y
riley flis	riley flis	y
anthony dawson	anthony dawson	y
matthew dennis	matthew dennis	y
caitlin barton-ancliffe	caitlin barton-ancliffe	y
lilian ransley	lilian ransley	y
molly webster	molly webster	y
pearson chapman	pearson chapman	y
madeleine mansell	madeleine mansell	y
mia nielsen	mia nielsen	y
sean peart	sean peart	y
james thomas	james thomas	y
benjamin dempsey	benjamin dempsey	y
imogen starkey	imogen starkdy	y
ella apostolakos	ella apostolyakos	y
amber lowe	amber lowe	y
aleisha simons	aleisha simons	y
fiona van kruyssen	fiona van kruyssen	y
lachlan-john hall	lachlan-john hall	y
gianni brasher	gianni brasher	y
jaxson bria	jaxson bria	y
heather jenkin	heather jenkin	y
darcy bennett	darcy bennjtt	y
joshua stubbs	josh stubbs	y
melinda duggan	melinda duggan	y
chloe shaddock	chloe shaddock	y
ashley morgan	ashlie morgan	y
jordan o'connor	jordan o'connor	y
benjamin mader	benjamin mader	y
amelie 	amelie 	y
madison malycha	madison malycha	y
trevor williams	trevor williams	y
brydon bressington	brydon bressington	y
mikayla sheehan	mikayla sheehan	y
liam hillier	liam hillier	y
 nottle	 nottale	y
alana clarkson	alana clarkson	y
max murray	max murray	y
max vu	max vu	y
joshua williams	joshua williams	y
luke bailey	ljke bailey	y
bailey harvey	bailey harver	y
dylan ederle	dylan ederle	y
joshua alfred	joshua alfred	y
daniella seabourne	daniella seabourne	y
jake dare	jake dare	y
amy van dyke	amy van dyke	y
noah de cesare	noah de cesare	y
matthew cain	matthew cain	y
ridley mcbeath	ridley mcbeath	y
jack donovan	jack donofan	y
ethan torr	ethan torr	y
emiily bolton	emiily bolton	y
brielle glen	briellre glen	y
emiily allert	emiily allert	y
grace fauth	grace fauht	y
ellen little	ellen little	y
matthew adams	matthew adams	y
daniel entwistle	daniel entwitle	y
 jeffcoat	 jeffcoat	y
danielle mertin	danielle mertin	y
mitchell biwer	mitchtll biwer	y
daniel nicholls	daniel nichlols	y
chloe oliver	chloe oliver	y
jock gregorovic	jock gregorovic	y
brodie minett	brodie minett	y
nathan 	nathan 	y
zachary meyer	zachary meyer	y
anneliese haskew	anneoiese haskew	y
anita ayton	anita ayton	y
natalia budge	natalia budge	y
talan harris	talan harris	y
elle lekakis	elle lekakis	y
tom palmer	tom palmer	y
alexander hawke	alexander hawke	y
darcy hodge	darcy hodge	y
jack harrison	jack harrison	y
sophie siggers	sophie siggers	y
molly walter	molly walter	y
tyler coligan	tyleir coligan	y
simon oakley	simon oakley	y
emma dirkis	emma dirkis	y
olivia wesley	olivi wesley	y
sam niejalke	sam niejwlke	y
hayley miller	hayley miller	y
sonja aitken	sonja aitken	y
cade genner	cade genner	y
grace brook	grace brook	y
abbie martin	abbie martin	y
isabella carr	isabella carr	y
bodhi williams	bodhi williams	y
jared hewett	jared hewett	y
luke ryan	luke ryam	y
nathan wright	nathan wright	y
alissa fowler	alissa fowler	y
laura kentish	laura kentish	y
kyle cash	kyle csh	y
john bourke	john bourke	y
tasman matthews	tasman matthews	y
charlotte connor	charlotte conno	y
kye callaghan	kye callaghan	y
benjamin ceplitis	benjamin ceplitis	y
ethan button	ethan butwton	y
riley sanders	riley sanders	y
brandon wicks	brandon wicks	y
jack saunders	jack saunuers	y
william penfold	wilkiam penfold	y
lauren migga	lauren migga	y
pearson bradicich	pearson bradifich	y
lucas needham	lucas needham	y
sarah schwaiger	sarah schwaiger	y
chelsie mcevoy	chelspe mcevoy	y
amy flemming	amy flemming	y
jordan waters	joran waters	y
kynan mcleavey	kyhan mcleavey	y
sophie ward	sophhe ward	y
harriet smith	harriet snith	y
 heffernan	 heffernan	y
daniel tomlins	daniel tomlins	y
thomas yip	thomas yi	y
riley harrison	riley harrison	y
mikaela dunlop	mikaea dunlop	y
caleb larkins	caleb larkins	y
edward hammersley	edward hammersley	y
kyle reszitnyk	kyle reszitnyk	y
caleb carr	caleb carr	y
isobel hobden	isoebl hobden	y
lachlan al majedy	lachlan al mjedy	y
caleb cripps	caleb cripps	y
chelsea schmidt	chelsea schmidt	y
bradley kennedy	bradley kennedy	y
joshua bryant	joshua brynat	y
ruby heffernan	ruby heffernwn	y
matthew mitolo	matthew mitolo	y
ashlee rowe	ashlee rowe	y
jaykob sunstrom	jaykob sunstrom	y
benjamin bell	benjamin bell	y
alisa francis	alisa franvis	y
mia lighten	mia lighten	y
jemma press	jemma press	y
rosa burgess	rosa burgess	y
jamilla bowan	jamilla bowan	y
karlee oakes	karlee oakes	y
francesco pedler	francesco pedle	y
lewis murray	lewis murray	y
tara gauci	tara gauci	y
blaize 	blaze 	y
samantha carins	samantha carins	y
 mclean	 mclean	y
charlie nicolle	charlie nicolle	y
sarah hallett	sarah hallett	y
matthew trewartha	matthew trewartha	y
abbey gannon	abbey gannon	y
archie carter	archie carter	y
bradley goodwin	bradley goodwin	y
harry james	harry james	y
sonja ellard	sonja ellard	y
shannon smith	shannon smith	y
charlie brown	charlie browvn	y
noah mclachlan	noah mclachlan	y
emiily licis	emiily lichis	y
matthew maslin	matthew maslib	y
jake russo	jake russo	y
lily stratton	lily stratton	y
coby najar	cogy najar	y
blake maggs	blake maggs	y
mitchell bartsch	mitchell bartsch	y
jayden saunders	jayden saunders	y
kayla watkins	kayla watkiws	y
oliver takiari	oliver takiari	y
olivia saegenschnitter	olivia saegenschnitter	y
reegan miller	reegan miller	y
taylah harvie	taylah harvie	y
nicholas barker	nicholas barkzr	y
bethany hagger	bethany hagger	y
isabelle williams	isabelle willinams	y
jake marten	jake marten	y
ebony allen	ebony allen	y
noah breden	noah breden	y
alexandra 	alexandra 	y
isabella wakefield	isabella wakefield	y
andrew pinneri	andrew pinneri	y
abbey backhouse	abbey backhouse	y
nikki nelowkin	nikki nelowkin	y
jordan muskett	jordan muskett	y
laura zappia	laura zappia	y
aaron everett	aron everett	y
hannah brill	hannah brill	y
joshua scarborough	joshua scarborough	y
wade rashleigh	wade rashleigh	y
lachlan murray	lachlan murray	y
talia hardy	talia hardy	y
griffin grant	griffin grant	y
jamilla ainsworth	jamilla ainsworth	y
henry thyer	henry thyer	y
emiily reader	emiily reader	y
lucy mugavin	lucy mugavin	y
alexander catt	alexander catt	y
emiily parker	emiily parker	y
patrick karras	patrick karrvas	y
chelsea morgan	chelsea morgan	y
bethany baker	bethany baker	y
judah clark	judah clark	y
danika wotherspoon	danila wotherspoon	y
brodee jolley	brodee jolliy	y
timothy prider	timothy prider	y
danielle savilla	danielle savilla	y
paris del tedesco	paris del tedesco	y
jesse stott	jesse stott	y
mitchell elsegood	mitchell elsegood	y
oscar hockey	oscar hockey	y
bianca welsh	bianca welsh	y
sascha cappo	sasch cappo	y
 hughes	 hugqhes	y
lara gibson	lara gibwon	y
nellie pollington	nellie pollington	y
charlie hamlyn	charlie hamlyn	y
joel leyvraz	joel leyvraz	y
julia mittiga	july mittiga	y
thomas shoudra	thomws shoudra	y
archie clift	archie clifth	y
jacob wells	jacob wells	y
matthew garman	matthew garman	y
abbey mccarthy	abbey mccarthy	y
rachel searles	rachml searles	y
silas mcarthur	silas mcarthur	y
connor schmidt	connor schmidt	y
jordan teuma	jordan teuca	y
noah demarco	noah demarco	y
india robinson	india robinson	y
madeline weatherly	madeline weatherly	y
madison sheehan	madison sheehan	y
bailey rout	bailey rout	y
garth hogan	garth hogan	y
sarah meaney	sarah meaney	y
emma hyland	emma hyland	y
rachael hollway	rachael hollway	y
breony ayris	breony ayris	y
kate baehnisch	kate baehnisch	y
mitchell sperling	mitchell sperling	y
caleb woodrup	caleb woodrup	y
esme partridge	esme partridge	y
indiana watts	indizna watts	y
jessica thomas	jessica thomas	y
timothy marshall	timothy marshall	y
alisa collins	alisa collijs	y
heather bourne	heather bourne	y
cooper zajko	cooper zajko	y
james kelley	james kell ey	y
skye leadbeter	skye leadbdter	y
ayla firt	ayla firt	y
samantha whitbread	samantha whitbread	y
tyler drew	tyler drew	y
julia smart	julia smart	y
garth yeoland	garth yeoland	y
lewis doherty	lewis doherty	y
pearson francis	pearson francis	y
william sheriff	william sheriff	y
sophie carey	sophie carey	y
hannah dalywater	hannah dalywater	y
jed stacey	jed stacey	y
jacob bennett	jacob bennett	y
holly tilley	holly tilley	y
elana cooper	elana coopdr	y
lily gould	lily gould	y
willow nuku	willos nuku	y
oscar garrett	oscar garrett	y
lucy dowling	lucy dowling	y
alexander richardson	alexander richardson	y
mitchell would	mitchell would	y
daniel harley	dan harley	y
jacqueline schmidt	jacquleine schmidt	y
zali bennett	zali bennett	y
kiera lawson	kiera lawson	y
casey potter	casey potter	y
jackson twomey	jackson twomey	y
marley phillis	marley phillis	y
lexie thomas	lexie thomas	y
kelsye brennan	kelsye 	y
thomas parker	thomas parker	y
tristan pritchard	tristan pritchard	y
samuel wilson	samuel wilson	y
sophie knipe	sophie knipe	y
jackson johnson	jackson johnson	y
april smith	aprbl smith	y
alana farr	alana farv	y
alexandra tran	alexandra tran	y
lara dolling	lara dollong	y
mia 	mia 	y
ciaran davey	ciaran davey	y
emma crosswell	emma crosswell	y
naomi mountstephen	naomi mountstephen	y
harry channon	harry channon	y
danielle van riel	danielle van rziel	y
james eddey	james eddey	y
bridget dash	bridget dash	y
jasper dodd	jasper dodd	y
georgia shephard	georgia shephard	y
dylan mcinerney	dylan mcinerney	y
alex bush	alex bush	y
alannah nadin	alannah nadin	y
levi oldfield	levi oldfield	y
hollie leach	hollie leach	y
jakob wright	jakob wright	y
 lienert	 lienekrt	y
katelyn blom	katelyn blom	y
natalia smith	natalia smith	y
bethany koch	bethany kocg	y
olivia cram	olivia craa	y
emiily kersten	emiily kersten	y
lily purdon	lily purdcon	y
sonja mckenzie	sonja mckenzie	y
melissa blackburn	melissa blackburn	y
tayla fazzini	tayla fazzini	y
isabelle waugh	isabelle waugh	y
lachlan krueger	lachlan kreger	y
tara wedding	tara weddeing	y
james allen	james allen	y
monique russo	monique russo	y
jacqueline amezdroz	jacqueline amezrdoz	y
matisse reid	matisse reid	y
lily pulford	lily pulfird	y
joel read	joel resd	y
dayna farrow	dayna farrow	y
brooke ryan	brooke ryan	y
hayden 	haiden 	y
shenae press	shenae prezs	y
sarah donley	sarah donley	y
zac crocombe	zac crocobe	y
madison belka	madison belka	y
dillon klobas	dilln klobas	y
roisin light	roisin light	y
luke parker	luke parker	y
jarryd smith	jarryd smith	y
max avery	max avery	y
natasha 	natasha 	y
jack marsh	jack marsh	y
simon kaminski	simon kaminski	y
taylah grocke	taylah grocke	y
jaggah philpott	jaggah philpott	y
tara ellis	tara ellks	y
darcy bown	darcy bown	y
caitlin nicopoulos	caitlin nicopoulos	y
brooklyn king	brooklyn king	y
christian corkery	christian corkersy	y
delaney ansell	delaney ansell	y
victoria mcmillan	victoria mcmillan	y
alexander dilena	alexander dilena	y
eliza loffler	eliza loffler	y
ellie springford	elli springford	y
alexander leedham	alexander leedham	y
jasmyn cantrell	jasmyn cantrell	y
ethan richley	ethan richley	y
jacob sinclair	jacob sinclair	y
zara runnalls	zara runnalls	y
timothy woodhouse	timothy woodhoise	y
emiily umapathysivam	emiily umapathysivam	y
jack hartleib	jack hartleib	y
kody uren	kody uren	y
annabelle hornby	annabelle hornby	y
gus mccartney	gus mccartney	y
corey holberton	corey holberton	y
nathan altus	nathan altus	y
jack juncken	jack juncken	y
sophie shea	sophie oshea	y
olivia tuckwell	olivia tuckwell	y
stella lowe	stella lowe	y
jarred faux	jarred faux	y
matthew francis	matthew stevenson	y
jacqueline phillips	jacqueline phillps	y
lara henrey	lara henrey	y
maggie rigozzi	maggie rigozzi	y
blake smith	blake smith	y
chloe giles	chloe giles	y
jesse atkinson	jesse atkinson	y
emiily rossi	emiily rossi	y
ebony gething	ebonpy gething	y
tiahnee simpson	tiahnee simpskon	y
sophie harris	sophie harris	y
tayah juers	tayah juers	y
kynan howard	kynan howard	y
cameron o'halloran	cameon o'halloran	y
emiily hopwood	emiily hopwood	y
jenna everingham	jenna everingham	y
blake viney	blake vinejy	y
jake stewart	jake stewart	y
kiara minge	kiara minge	y
luke mathewson	luke mathewson	y
jai dougan	jai dougan	y
alexander lockley	alexander lockley	y
jarvis mckenzie	jarvis mckenzie	y
claudia asche	claudia asche	y
jack carruthers	jack carruthers	y
sebastian phillis	sebastian phillis	y
nicholas betterman	nicholas betterman	y
timothy hopgood	timothy hopgood	y
kaleb 	kaleb 	y
lushia rusby	lushia rusby	y
amy gunner	amy gunner	y
lachlan lang	lachlan lang	y
abbey plummer	abbey plumer	y
 hall	 hall	y
timothy gehlig	timothy gehlig	y
hayley oldham	hayley oldjam	y
amy plenty	amy plenty	y
mitchell langeluddecke	mitchell langeluddecke	y
brydee mcnicol	brydee mcnicol	y
madeleine finlayson	madeleine finlayson	y
jacob reynolds	jacob reynolcs	y
ellouise hawkes	ellou ise hawkes	y
jasper barone	jasper barone	y
tara wheatley	tara wheatley	y
emiily bruins	emiily bruins	y
jacob murrell	jacob murrell	y
annabel kitson	annabel kitson	y
alexander broadwood	alexander broadwood	y
shane patmore	shane patmore	y
sara berry	safa berry	y
connor williams	connor williams	y
brendan megaritis	brendan megaritis	y
nicholas 	nick 	y
kale little	kayle little	y
ty hart	ty hart	y
matthew yeates	matthew yeates	y
james pierce	james pierce	y
bailey johnstone	bailey johnstone	y
zachary wojtaszak	zachary wojtaszak	y
christian ruse	christian ruse	y
harry hoadley	harry hoadley	y
talena tretheway	talena tretheway	y
brody wark	brody wark	y
annalise szczepanski	annalise szczepanski	y
dillon barnes	dillon bairnes	y
caitlin sladojedic	caitlin sladojedic	y
tahlia meegan	tahlka meegan	y
william cutri	william cutriv	y
finlay williamson	finlay williamson	y
flynn angel	flynn angel	y
charlotte hemsley	charlotte hemsley	y
scott flaherty	scott flaherty	y
holly brennan	holly brejnan	y
nicholas 	nicholas 	y
chantelle boccaccio	chantelle boccacico	y
lily bradford	lilh bradford	y
sara direen	sar direen	y
sophie kennedy	sophie kennedy	y
breeanne phillips	breeanne monson	y
takara spry	takara spry	y
 grealy	 grealy	y
edward clark	edward clark	y
maconal radomi	maconal radomi	y
harrison kelly	harrison kelly	y
tiana svensson	tiana svensson	y
paris shearing	paris shearing	y
thomas dennis	thomas dennis	y
alana 	alana 	y
faith jones	faith jones	y
jacob giatas	jacob giatas	y
erin kovaleff	erin hughes	y
jordan richards	jordan richards	y
alyssa michael	alyssa michael	y
jordan miller	joran miller	y
lexie gettaw	lexie gettw	y
amber james	amber james	y
amy mckay	amy mckay	y
magnus earl	magnud earl	y
imogen simaan	imogen simaan	y
freya harmer	freya harme	y
joshua reichelt	joshja reichelt	y
jasmyn burton	jasmyn burfon	y
harry poulson	harry poulson	y
lachlan manuel	lachlan manuel	y
 ratcliffe	 ratcliffe	y
rebecca catchpole	rebecca catchpole	y
leon royal	leon royal	y
mikayla johnson	mikayla johnson	y
toby 	tovy 	y
andie edmiston	andie edmistin	y
amber newman	amber newman	y
george hickman	george hickman	y
zachary williams	zachary williams	y
joshua mcswain	joshua mcswain	y
tristan chapman	tristan chapman	y
harry hall	harry hal	y
alexander churches	alexander churches	y
george williams	george williams	y
shanaye torres	shanaye torres	y
jonathon bell	jonathon bell	y
jack nelson	jack nelson	y
isaac fifth	isaac fifth	y
savannah carmichael	savannah carmichael	y
mia mckerney	mia mckefney	y
declen rodell	declen rodell	y
alex frankland	alex frankland	y
 rabe	 rabe	y
bryce cunningham	bryce cunningham	y
caitlin stebbeings	caitlin stebbefngs	y
jesse maloney	jesse maloney	y
maddison manley	maddisln manley	y
elysse lane	elysse lane	y
adam barber	adam barber	y
thomas britt	thomas britt	y
brody watts	brody watts	y
henry kalitsounakis	henry kalitsounakis	y
oakleigh eaton	oakleigh eaton	y
liam ford	liam ford	y
lucy ambrosino	lucy ambrosino	y
sophie wheldon	sophie wheldon	y
harrison duke	harrison duke	y
mason wyatt	mason wyatt	y
jordan lilley	jordan lilley	y
jackson hagger	jackson hagmger	y
brinley inns	brinley inns	y
timothy duncan	timothy duncan	y
 tkaczuk	 tkaczuk	y
joel woodifield	jotl woodifield	y
april elsegood	april elsegood	y
 caldicott	 caldicott	y
elle milbourne	elle milbourne	y
brooke davidson	brooke davidson	y
mila jennings	mila jennings	y
 smolej	 smolej	y
ethan hiscox	ethan hiscox	y
lachlan anderson	lachlan anderdon	y
jye morris	jye morcis	y
 hewlings	 hewlings	y
brooke millard	brooke millard	y
benjamin farey	benjamin farey	y
brianna davis	brianna davks	y
lara law	lara law	y
mikhayla 	mikhayla 	y
james hill	james hill	y
alexander hinze	alexander hinze	y
jack gibbs	jack gibbs	y
isabelle pollock	isabelle pollpck	y
chelsea trentelman	chelsea trentelman	y
ryan dolman	ryan dolman	y
harry bransden	harry bransden	y
william dimartino	william dimartino	y
nicholas ohlson	nichokas ohlson	y
bianca milner	bianca milner	y
logan mackenzie	logn mackenzie	y
sophie ranse	sophie 	y
aneka matthews	aneka matthews	y
hamish werner	hamish werner	y
alysha champion	alysha chapion	y
molly oxer	molly oxer	y
lucas holy	lucas holy	y
hayley marcelja	hayley marcelja	y
malakai beecken	malakai beecken	y
rebecca ivic	becky ivic	y
bianca withers	bianca withers	y
 burdon	 burdon	y
isabella parker	isabella parker	y
peter heath	peter heath	y
emma brewster	emma brewster	y
charli fitzgerald	charli fitzgerald	y
claudia imaschew	claudia imaschew	y
charlotte fotiadis	charlotte fotiadis	y
emiily ford	emiily fodr	y
noah posselt	noah posselt	y
jordan wilson	jordan wilson	y
nathan gough	nathan gough	y
montana reiss	montana reiss	y
amy a'church	amy a'church	y
holly tapp	holly tapp	y
samuel crawford	samuel craford	y
brodee belbin	brodee bekbin	y
thomas brown	thomas brown	y
zachariah zanker	zachariah zanekr	y
ella zhu	teresa zhu	y
kasey davey	kasey davey	y
grace peterson	grace peterson	y
daniel farrell	daniel farrell	y
samantha field	samantha field	y
blakeston grimes	blakeston grimea	y
 turner	 turner	y
ethan fogarasi	ethan fogarasi	y
ronan cashman	ronan cashman	y
jacob medhurst	jacb medhurst	y
jacob wellington	jacob wellington	y
isabella shephard	isabella shephard	y
sarah mcgorm	sarah mcgorm	y
timothy tuck	timothy tuck	y
kristen silis	kristen silis	y
kyle gordon	kyle gordon	y
cambell imbra	cambell imbra	y
molly catalano	molly catalano	y
isabella bramley	isabella braley	y
sebastian hoelscher	sebastian hoelscher	y
phoebe weissflog	phoebe weissflog	y
cain lang	cain lang	y
emiily eadie	emiily eadie	y
ky ebert	ky ebert	y
 ball	 ball	y
esther shields	esther shields	y
charles dillon	charles dillon	y
thomas woolf	thomas woolf	y
nathan adams	nathan adams	y
liam bolsius	liam bolsus	y
finn robinson	finn robinson	y
kimberly gartner	kimberly gartner	y
emiily ewen	emiily ewen	y
harry fryer	harry fryer	y
arabella read	arabella read	y
jake leecroft	jake leecroft	y
tuscany hamilton	tuscany hamilton	y
alexander williams	alexander williams	y
jeremy beaumont	jeremy beaumont	y
nicholas o'brien	nicholas o'brien	y
max gebert	maz gebert	y
hannah hutton	hannah huttcn	y
mhary roberts	mhary roberts	y
emiily brereton	emiily brereton	y
hannah hewitt-reid	hannah hewitt-reid	y
daen leys	daen leys	y
noah morton	noah morzton	y
matthew lambert	mat lambert	y
tristan cureton	tristan cureton	y
sybella keam	sybella keam	y
mikhayla poynder	mikhayla poynder	y
 jordans	 jordans	y
max towers	max towers	y
tyler 	tyler 	y
zoe green	zoe green	y
benjamin cato	benjamin cato	y
abii hann	abii hann	y
jordan paech	jordan paech	y
alia willson	alia willson	y
eden overeem	eden overeem	y
blake harris	blake harris	y
james butterfield	james butterfield	y
joshua lawson	joshua lawson	y
rourke dobson	rourke dobson	y
emiily mastrangelo	emiily mastrangelo	y
sophie denyer	sophie denyer	y
jessica 	jessica 	y
benjamin vinall	benjamin vinall	y
jacob carse	jacob carse	y
joshua king	joshua king	y
ruby laurence	ruby laurence	y
tenille quintrell	tenille quintrell	y
james skyum	james skymu	y
stephanie kegel	stephwnie kegel	y
larissa noble	larissa nobel	y
oscar cox	oscar cox	y
olivia germinario	olivia germinario	y
daniel adnams	daniel adnams	y
ella connell	ella connell	y
samantha thorne	samantha thorne	y
sophie wait	sophie wait	y
amber shepherd	amber shepherd	y
isabelle mcgregor	isabelle mcgregor	y
jake kerr	jake kerr	y
faith waddell	faith waddell	y
jordan pix	jordan pix	y
georgia blann	georgia blann	y
alexandra mcdonald	alexandra mcdonald	y
isabella brooks	isabella brooks	y
kelsye kollosche	kelsye kollosche	y
 okninski	 okninski	y
riley willoughby	rioey willoughby	y
tayah brooks	tayah broos	y
nicholas carney	nicholas carney	y
 o'brien	 o'briwn	y
garth wright	garth wright	y
georgia robinson	georgia robinson	y
juliana kennewell	juliana kennewell	y
sara-louise whittingham	sara-louise whittingham	y
sophie porteus	sofia porteus	y
jorja kellaway	jorja kellaway	y
lauren baird	lauren baird	y
seanna fejo	seanns fejo	y
layla graham	layla graham	y
james munyard	james munyard	y
jye kaminski	jye kaminski	y
liam unwin	liam unwin	y
oliver mckinlay	olivet mckinlay	y
kyle hatch	kyle hatch	y
joshua bartlett	joshua bartlett	y
freya white	freya white	y
david fitzgerald	david fitzgerbald	y
emiily goodrich	emiily goodrich	y
larissa swales	larissa swales	y
ethan thornton	ethan thornton	y
deakin telfer	deakin makings	y
emma petrie	emma petrie	y
bethany devine	bethany devine	y
finn warsap	finn warsap	y
madison iarriccio	madison iarriccio	y
owen bell	oen bell	y
lynton deacon	lynton deacon	y
eliza gugliotta	eliza gugliotta	y
jarryd kyriazopoulos	jarryd kyriazopoulos	y
molly bean	molly bean	y
garth ransom	garth ranslm	y
stirling 	stirling 	y
noah evans	noah evans	y
megan farrington	megan farrington	y
christopher warren	christopher warrdn	y
zebediah murray	zebediah murray	y
joshua kammermann	joshua kammermann	y
tara marotta	tara marotta	y
james abbott	james abbott	y
nellie mccoy	nellie mccoy	y
aiden hart	aiden hart	y
brianna waterman	 waterman	y
zachary amos	zachary amos	y
flynn wood	flinn wood	y
jessica achilles	jessica achilles	y
hannah brooks	hannah brooks	y
ebony tscharke	ebony tscharke	y
oliver stanley-smith	oliver stanley-smith	y
 bannister	 bannister	y
christian turner	christian turner	y
tara jenkins	tarah jenkins	y
travis raven	travis raven	y
annabelle medhurst	annabelle medhurst	y
riley nankervis	riley nankervis	y
griffin lane	griffin lane	y
cooper clarke	cooper clarke	y
emiily woolley	emiiy woolley	y
rebecca bell	rebecca belx	y
taylah buckley	taylah buckley	y
brooke hill	brooke hill	y
ryan hubbard	ryan hubbard	y
amy allan	amy allan	y
will hughes	will hughes	y
jessica rebecca	jessica rebecca	y
mikayla fanning	mikayla faninng	y
alexander hamon	gianni hamon	y
holly brown	hol ly brown	y
shae engstrom	shai engstrom	y
eliza weir	elza weir	y
zane van namen	zane van namen	y
harrison green	harrison green	y
connor phillips	connor phillips	y
kaela healy	kaela healy	y
madison barr	madison barr	y
william jacobson	willian jacobson	y
sam walden	sam walden	y
nasyah edwards	nasyah edwards	y
lucas salcedo	lucas salcedo	y
elijah stilgoe	elijah stilgoe	y
liam jordan	liam jordan	y
emiily barnett	 barnett	y
jack mcmaster	jack mcmastef	y
tyler parker	tyler parker	y
ethan radin	ethan radin	y
jamie williams	jamie williams	y
sienna gillam	sienna gillam	y
alaiyah wagener	alaiyah wagener	y
 ferraro	 ferraro	y
lachlan flaherty	lachlan flaherty	y
kelsy beaton	kelsy beaton	y
sophie morrissey	sophie morrissey	y
jamie behrens	jamie behrens	y
julia dalakis	julia dalakis	y
oscar weston	oscar weston	y
rhiannon oats	rhiannon oats	y
jack carling	jack carling	y
hugo castles	hugp castles	y
monique altamura	monique altamura	y
nacoya noble	nacoyb noble	y
brigitte nettleton	brigitte 	y
oliver van hooff	oliver van hoonff	y
lauren hewes	lauren hewes	y
hayley poulos	haygley poulos	y
alisha marriott	alisha marriott	y
annabel scanlon	annabel scanlon	y
thomas mcgrady	thomas mcgfady	y
benjamin gilgen	benjamin gilgen	y
brydee fatchen	brydee fatchen	y
vincent sayers	vincent sayers	y
benjamin davy	benjamin davy	y
kailey riddle	kailey riddle	y
aaron owen	aaron owen	y
ned dean	ned dean	y
lucy thompson	lucy thompson	y
christina shegog	christina shegog	y
dakota arthur	dakota arthur	y
chase kosmidis	chase kosmidis	y
hannah finlayson	hannah finlayson	y
clement vanderwoude	clememt vanderwoude	y
pace stewart	pace stewart	y
corie wells	corue wells	y
ben tran	ben tran	y
olivia barton	olivia barton	y
abbey nienaber	abbdy nienaber	y
ethan lodge	ethan lodge	y
luke stevens	luke stevens	y
madeline tremlett	madeleine tremlett	y
shaun dennis	shaun dennis	y
hannah rivera	hannah rivera	y
jesse durden	jesse durden	y
petreece foundas	petrece foundas	y
emiily shoemaker	emiily shoemaker	y
bethany lysakowski	bethajy lysakowski	y
makenzie sauerwald	makenzie sauerwald	y
steven miller	stevdn miller	y
matilda tagg	matilda tagg	y
spencer gentilcore	spencer gentilcore	y
george doyle	george doyke	y
benjamin parks	benjamin parks	y
rebekah brooks	rebekah brooks	y
alexandra janssens	alexandra janssens	y
darcy pryor	darcy pryor	y
jemma smith	jemma smith	y
logan gleeson	logan gleeson	y
taliah jerram	taliah jerram	y
shelby hocking	shelvy hocking	y
daniel blesing	daniel blesing	y
lachlan snook	lachlan snook	y
hugo szeto	hugo szeo	y
adam barton	adam barton	y
mia edwards	mya edwards	y
claudia wyllie	claudia wyllie	y
caleb jiggins	caleb jiggisn	y
nathan hobday	nathan hobday	y
harry millar	harry millar	y
samara goodyer	samara goodyer	y
brooke kalman	brooke kalman	y
ainsley buckman	ainsley buckman	y
campbell franklin	campbell franklin	y
alexandra falkenberg	alexandra falkenberg	y
andie mcbride	andie mcbride	y
imogen ey	imogen ey	y
kiera hilditch	kiera hildirch	y
tabitha pendrich	tabitha pendrich	y
katelyn english	katelyn english	y
benjamin dello-lacovo	benjamin dello-lacovo	y
ashley jones	ashley jones	y
amelie holland	amelie holland	y
sophie browning	sophie browning	y
ned scott	ned scott	y
daniel duncan	daniel dunan	y
jared petrovic	jared petrovic	y
charles dickson	charles dickson	y
lewis barnett	lewis barnett	y
alex gould	alex gould	y
lachlan pyne	lachlan pyne	y
lewis connor	lewis connor	y
luke shepperd	luke shepperd	y
cameron wong	cameron wogn	y
isabella roe	isabella roe	y
sophie lukich	sophie lukich	y
 tollenaar	 tollenaar	y
joshua lanzon	joshua lanzon	y
lucas kamaruddin	lucas kamaruddin	y
hannah fisher	hannah fisver	y
patrick filmer	patrick filmer	y
ella simounds	ella simounds	y
samantha harrison	samantha harrison	y
cade clanchy	cade clanchy	y
chelsea estreich	chelsea estreich	y
kyra manning	kyra manning	y
lachlan silver	lachlan silver	y
bradley wiese	bradley wiese	y
jenna johnson	jenna johnson	y
kye manwaring	kye manwaring	y
michael callow	micah callow	y
daniel ball	daniel bapll	y
noah pratt	noah pratt	y
brianna austen	brianna austen	y
william tongun	william tongun	y
jack whiting	jack whiting	y
jakob battersby	jakob battersby	y
liam mcguinness	liam mcguinness	y
kylee delfabbro	khlee delfabbro	y
melanie kitt	melanie kitt	y
cooper potter	cooper potter	y
william jarman	william jarnan	y
lara gascoigne	lara gascoigne	y
alessandria 	alessandria 	y
lauren bosworth	lauren bosworith	y
isabella jenkinson	isabella jenkinson	y
tarshya gibbons	tardhya gibbons	y
hayley martin	hayley martn	y
tyler jones	tyler jones	y
nicholas mcnamara	 mcnamara	y
kieren weston	kieren western	y
thomas bellofatto	thomaz bellofatto	y
brydon jury	brydon jury	y
nikita richardson	nikita richardson	y
tuscany mcallister	tusdany mcallister	y
mitchell passmore	mitchell passmore	y
 pobjoy	 pobjoy	y
william griffiths	william griffiths	y
jasmyn lucas	jasmyn lucas	y
joel becher	joel becher	y
ebony foster	ebony foster	y
kaitlyn papagiannis	kaitlyn papagiannis	y
lucas wilson	lucas wilson	y
meggie selby-reid	meggie selby-feid	y
andie harley	andie harley	y
lucy ritter	lucy ritter	y
harrison lill	harrison lilk	y
lucas williams	lucas willilams	y
larissa bailey	larissa bailey	y
sarah barrington	sarah barrikngton	y
madison sullivan	madison sullivan	y
logan ketchell	logan ketchell	y
talia hall	talia hall	y
kelsy rice	kelsy rice	y
michael inkster	michael inkster	y
liam hinchlisfe	liam hinchlisfe	y
mhary martyn	mhary marttn	y
isabelle hutcheon	isabelle hutcheon	y
nicholas harris	nicholas harris	y
lucas sexton	lucas sexton	y
anthony bove	anthony bove	y
katie andrews	katie andrews	y
felicity korol	felicbty korol	y
jaxson donolley	jaxson donolley	y
zac sharpe	zac sharpe	y
nicholas babidge	nicholas babioge	y
sarsha sawyer	sarsha sawyer	y
nicholas griffiths	nicholas griffiths	y
zane killworth	zane killworth	y
carlin gough	carlin gouh	y
cheree custance	cheree custance	y
elli hart	elli hart	y
sophie hunt	sophie hunt	y
jesse green	jessu green	y
harrison abel	harrison abel	y
emiily wellman	emiily wellman	y
flynn filipovic	flynn filipovic	y
alicia everts	alicia everts	y
matthew johns	mattnew johns	y
matthew paillin	matthew paillin	y
thomas king	thomxs king	y
daniel dempster	daniel dempster	y
olivia windsor	olivia windsor	y
hugo bain	hugo bailn	y
charlie hummerston	charlie hummerston	y
cameron lynch	camdron lynch	y
tylah birbilopoulos	tylah birbilopoulos	y
samantha butler	samanrha butler	y
joshua emmett	joshua emmett	y
lochlan zollo	lochlan zollo	y
micaela nash	micaela nasr	y
chase murray	chase murray	y
james mchugh	jamea mchugh	y
fraser egan	fraser egan	y
tony kesic	tony kesic	y
katelyn patria	katelyn patria	y
 towns	 towns	y
benjamin barrie	benjamin barrke	y
lucy burman	lucy burman	y
angelica frith	angelica frith	y
georgia jenson	georgia jenson	y
joshua blizzard	joshua blizzard	y
gabriella mauger	gabriellda mauger	y
hannah moore	hannah moore	y
brooke hood	brooke hood	y
carlin 	caroin 	y
fyynlay solly	fynlay solly	y
jaslyn spaander	jaslyn spaander	y
riley le	riley le	y
sophie chance	sophie chance	y
claudia king	claudia king	y
james perry	javes perry	y
lily jasek	lily jasek	y
imogen kupke	imogen kupke	y
tara musa	tara muss	y
liam campion	liam campion	y
holly collins	hollie collins	y
hannah burns	hannah burns	y
 bavaro	 bavaro	y
india maher	india maher	y
emma o'connell	emma o'connell	y
amy jaber	amy jaber	y
amy corbo	amy corbo	y
april rohde	april rohde	y
teaha byrne	teaha byrne	y
hayley grebenshikoff	hayley grebenshikoff	y
tayla schulze	tayla schulze	y
ciaran eyre	ciarzn eyre	y
bree hassouros	brde hassouros	y
dante patterson	dante patterson	y
abii boatwright	abii boatwright	y
jarvis simpson	jarvis simpson	y
samuel moy	samuel my	y
layla coker	layla coker	y
jackson walker	jackson walker	y
amber gurr	amber gure	y
jacob 	jacob 	y
caitlin chandran	caitlin chandran	y
oliver creech	oliver creech	y
alicia farrugia	aliciq farrugia	y
noah sun	noah sun	y
robbie collins	robbie collins	y
emiily o'connell	emiily o'connell	y
joshua griffiths	joshuw griffiths	y
james 	james hutt	y
kirrah town	kirrah town	y
harrison dicker	harrison dicker	y
benjamin mcmartin	benjamin mcmartin	y
amalia kingston	amalia kingston	y
oscar fiotakis	oscar fiotakis	y
james flaws	james flaws	y
pace burgess	pacd burgess	y
nicholas jacobi	nicholas jacobi	y
jasmin rohrlach	jasmin rohrlach	y
dylan hindmarch	dylan hindmarch	y
hayden evans	hayden evans	y
jayden perkins	jayden perkigs	y
noah khoe	noah khoe	y
jackson wilson	jackson wilson	y
samantha mcmenemy	samantha mcmenemy	y
bethany wilton	bethany wilton	y
noah 	noh 	y
sophie bourchier	sophie bourchier	y
jack hosking	jack hosing	y
judah smith	judah smith	y
william riseley	william riseley	y
katelyn winckel	katelyn winckel	y
samuel schwarz	samuel schwarz	y
prudence lyons	prudece lyons	y
elli sherriff	elli sherriff	y
amelia sutherland	amelia sutherland	y
michael fleetwood	michael fleetwood	y
talissa pycroft	talissa pycroft	y
jack frost	jack frost	y
noah bamberger	noah bamberger	y
blake layther	blake layther	y
elly sumner	ellu sumner	y
jaiden 	jaiden 	y
hannah weidner	hannah weidnder	y
alyssa dellorco	alyssa dellorco	y
cameron pestka	cameron pestka	y
kelsea christie	kelsea christie	y
jake fraser	jake fraser	y
georgia baumane	georgia baulane	y
lauren albrecht	lauren albrecht	y
thomas 	thomas 	y
lily shepherd	lily shexherd	y
emma tonkin	emma tonkin	y
hayden vidovic	hayden vidovic	y
spencer haines	spencer haines	y
james mccaul	jamed mccaul	y
evan redding	 redding	y
andrew mair	andrew mair	y
matthew rack	matthew rack	y
libby zanchetta	libby zanchetta	y
samantha williams	samantha williams	y
olivia bell	olivia bell	y
madison loxton	madison loxton	y
joel o'meara	joel o'meara	y
toby olsen	toby olsen	y
joshua white	joshus white	y
mitchell jakobsson	mitchell jakobsson	y
nicholas mclaughlin	nicholas mclaughlin	y
keeley marcoionni	keeley marcoionni	y
jarred nuttall	jarred nuttall	y
caitlin townsend	caitlin townsend	y
tayah victor-gordon	tahah victor-gordon	y
madeleine bos	madeleine bos	y
daniel thorson	daniel thorson	y
alec bahr	alec bahr	y
andrew ablett	andrew ablett	y
casey fisher	casey fisher	y
bayden welsh	bayden welsh	y
brigette kaukas	brigetye kaukas	y
sarah madzia	sarha madzia	y
nasyah blacker	nasyah blacker	y
 angus	 angus	y
tayah bowey	tayah bowey	y
riley mckerlie	riley mckerlie	y
megan conley	megan conley	y
jayden ryan	jayden ryan	y
troy mitchell	troy mitchwll	y
 munro	 munro	y
marianne bailey	marianne bailey	y
erin sheridan	erin sheridan	y
richard baggaley	richard baggaley	y
thomas brooks	tomme brooks	y
jack innes	jack innes	y
jacob searle	iacovo searle	y
kristen smith	kristen smith	y
 sharpe	 sharpe	y
caleb reid	caoeb reid	y
joshua fooks	joshua fooks	y
ava ganley	ava ganley	y
hunter molzer	hunter molzer	y
cameron sloane	cameron sloane	y
zoe morgan	zoe morgan	y
blake maclean	blake maclean	y
ebony stennings	ebony stennings	y
alexandra kerr	alexadnra kerr	y
vanessa lowe	vanessa lowe	y
zac wilks	zac wilks	y
pace george	pae george	y
mitchell neelands	mitchell neelands	y
joshua petersen	joshua petersen	y
lachlan watson	lachlan watson	y
adam rengers	adat rengers	y
tyler essen	tyler essen	y
ebony jackson	ebony jackson	y
georgia featherstone	georgia featherstone	y
juliana heppner	juliaa heppner	y
jai french	jai french	y
campbell thiele	campbell thiele	y
joshua woolan	joshua woolan	y
harry van der linden	harry van der linden	y
taylah hughes	taylah hughes	y
thomas wilson	thomas wilson	y
michael bertels	michael bertls	y
zachary grigg	zachaty grigg	y
andrew fitzpatrick	andrew fitzpatrick	y
oliver jowett	olvier jowett	y
henry lonergan	henry lonergan	y
jared plane	jared plane	y
luke carey	luke carey	y
silas atkinson	silas atkinson	y
seth meszaros	seth meszaaros	y
gabrielle jones	gabrielle jones	y
joshua andrews	josohua andrews	y
leo rodda	leo rodda	y
cameron farnden	cameron farnden	y
thomas beveridge	thomas beveridge	y
mitchell latham	mitchell latham	y
elly 	elly 	y
finn west	finn west	y
zac redden	zac redden	y
kate chesson	kate chesdon	y
mackenzi housego	mackenzi housego	y
mitchell parancin	mitchell parzancin	y
eliza taylor	elzia taylor	y
jack lyon	jack lyon	y
brigette rachaganathan	brigette rachaganathan	y
aidan sydes	aidan sydes	y
luke birss	luke birss	y
thomas reid	thomas reid	y
jasmin adlard	jasmin adlard	y
sara novice	sara novice	y
jessica kelly	jessie kelly	y
chloe parkinson	chloe parkinson	y
emiily rayment	emiily rayment	y
talia rosanno	talia rosanno	y
jack sickert	jack sickert	y
jacob stobee	jacob stobee	y
kelsey douglas	kelsey douglas	y
joel coe	joel coe	y
ellouise griffiths	 griffiths	y
peyton mercer	peyton mercer	y
hanna brown	hanna brown	y
 lai	 lai	y
georgia vines	georgia vines	y
sonja quick	sonja quifk	y
amber stapleton	amber stapleton	y
lara lunam	lars lunam	y
byron kay	byron kay	y
chloe comelli	chloe comelli	y
grace campbell	grace campbell	y
teresa grieve	teresa grieve	y
emiily crawford	emiily crawford	y
bradley wigley	bradley wigly	y
erin humby	erin hujby	y
maggie gross	maggie gross	y
emma ballard	emma ballard	y
claire mcnab	claire mcnab	y
stephanie porter	stephanie porter	y
callum 	callum 	y
courtney mcdermott	courtney mcdermott	y
lily compagne	lily compagne	y
annabelle stoker	annabelle stoker	y
michael bond	michael bond	y
jacinta sanders	jacinta sanders	y
roberta huynh	roberta huynh	y
sarah hubber	sarah hubber	y
zachary garforth	zachary garforth	y
phoebe dorney	phoebe dorney	y
destynii rowbottam	destynii rowbottam	y
abbey grant	abbey grant	y
sophie auch-schwelk	sophie auch-schwelk	y
michaela fullston	micaela fullston	y
jacqueline wakefield	jacqueline wakefield	y
sophie qua	sophie qua	y
georgia slotegraaf	georgia slotegraaf	y
gemaley linke	gemaley linke	y
teagan hoare	teagan hoare	y
simone thornhill	simone thornhill	y
evan brown	evan brown	y
keira hawkes	keira hawkes	y
millie neill	millie neill	y
samantha lindblom	samantha lindblom	y
brayden noble	brayden noble	y
ridley millhouse	ridley millhouse	y
tiana braithwaite	tiana braithwaite	y
amy tily	amy tily	y
oliver riggs	oliver riggs	y
nicholas holberton	nicholas holberton	y
spencer gardasevic	spencer gardasbvic	y
schkirra bibby	schkirra bibby	y
mitchell goodson	mitchell goodson	y
maxin 	maxin 	y
imogen lee	imogen lee	y
danielle schirripa	danielle schirripa	y
callum tree	callum tree	y
logan whittle	logan whittle	y
nathan jennings	nathan jennings	y
alison desaro	alisob desaro	y
holly mcalpine	holly mcalpine	y
brooke abell	brooke abell	y
jack galloway	jack galloway	y
abbey edwards	abbey edqards	y
lachlan shires	lachlan shires	y
jack hedger	jack hedger	y
brooke mashado	brooke mashado	y
 hampton	 hampton	y
joshua ramsey	joshua ramsey	y
isabelle small	isabelle small	y
madeline fryer	madeline fryer	y
kalli woodward	kalli woodwazrd	y
karli watts	karzli watts	y
lauren 	lauren 	y
joshua murcott	joshua murcott	y
jayden crawford	jayden crawford	y
cheree lehman	cheree lehman	y
zachary sherlock	zachary sherllck	y
jaden crafter	jaden crafter	y
jessica williams	jessica williams	y
james ward	james ward	y
sophie jokinen	sophie jokinen	y
 bygraves	 bygraves	y
sophie belcher	sophie belcher	y
oscar danthanarayana	oscar danthanarayana	y
clain bygrave	clakn bygrave	y
samantha bammer	samantha bammer	y
alyssa bartlett	alyssa bartlett	y
michael perry	michael perry	y
lochlan edwards	lochlan edwards	y
georgia dunstan	georgia dunstan	y
holly mccallum	holly mccallium	y
 ingman	 ingman	y
deakin hoare	deakin hoare	y
tiarna joseph	tiarna joseph	y
ella giamoukoglou	ell giamoukoglou	y
emiily shelley	emiily shellry	y
wilson reeve	wilsoj reeve	y
daniel gray	daniel gray	y
vanessa brown	vanessa brown	y
nicholas burns	nicholas burns	y
anthony whennen	anthony wheneen	y
harrison hughes	harrison hughes	y
alisa winch	alisa winch	y
liam walker	liam walker	y
adam kolman	adam kolma	y
charlee 	charlee 	y
mollie 	mollie 	y
fynn 	fynn 	y
mitchell dorney	mitchell dorney	y
matthew russell	matthew russll	y
lillianna sage	lillianna sage	y
joshua tidswell	joshua tidswwll	y
lily sanchez	lily sanchez	y
xanthe 	xanthe 	y
drew werner	drew werner	y
annabel hunt	annabel hunt	y
emiily hatcher	emiily hatcher	y
jacob potticary	jacob pottifary	y
jakob newman	jalob newman	y
aleisha blown	aleisha blown	y
ebony reid	ebony reid	y
emiily heruc	emiily heruc	y
jack daniell	jack daniell	y
brianna tuckwell	brianna 	y
joel anderson	joel anderson	y
zack carr	zack carr	y
tiana secombe	tiana secombe	y
laura andrew	laura andrew	y
hayden terry	hayden terry	y
ryan fidge	ryan fidge	y
giuliana temby	giuliana temby	y
charlie brook	charlie brook	y
macey heazlewood	madey heazlewood	y
olivia perkins	olivia perkins	y
oliver sparnon	oliver sparnon	y
adrian karpathakis	adrian karpathakis	y
rachel parsons	rachel parsons	y
simone tsoutsakos	simone tsoutsakos	y
lily clogg	lily clogg	y
aaliyah van pelt	aaliuah van pelt	y
jessica ponton	jessica ponton	y
connor yuen	connor yuen	y
tyler burden	tyler burden	y
alexandra applin	alessandria applin	y
oliver hall	oliver hall	y
liam gaskin	liam gaskin	y
jamie moore	jamie moore	y
miller 	milelr 	y
emiily dawson-ryan	emiily dawson-ryan	y
annabella greenslade	annabella greenslade	y
coby pickering	coby pickering	y
riley downie	riley downie	y
liam brooks	liam brooks	y
lachlan murphy	lachlan murphy	y
oliver wallace	oliver wallace	y
mackenzie vince	macenzie vince	y
charlotte francis	charlotte francis	y
luke detemmerman	luke detemmerman	y
benjamin waterworth	benjamin watewrorth	y
jasper morgan	jasper morgan	y
ryan umlauff	ryan umlauff	y
blakeston reynolds	blakeston reynolds	y
samuel hoang	samuel howng	y
mia downing	miq downing	y
xavier davies	xavier davies	y
silas christie	silas christie	y
jessica hennessy	jessqca hennessy	y
nicholas dabrowski	nicholas dabrowski	y
kirrah nicholson	kirrah nicholson	y
max radley	mac radley	y
joshua mikkelsen	joshua mikkelsen	y
harrison butler	harrison butler	y
zachariah grace	zachariah grace	y
tayla williams	tayla williams	y
kalli griffin	kalli griffin	y
daniele raman	daniele raman	y
lucy matthews	lucy matthews	y
timothy humphries	timothy humphries	y
madison vanderlink	madison vanderlink	y
jessica butt	jessica butt	y
kiera scott	kiera scott	y
charli macpherson	charli macpherson	y
maya aistrope	maya aistrope	y
jinni williams	jenna williams	y
joel thompson	joel thompson	y
brett arulampalam	brftt arulampalam	y
mystique rear	mystique rear	y
ellie 	ellie 	y
caitlin ferraro	caitlin ferraro	y
hannah whitlock	hannah whitlock	y
christian hall	chridtian hall	y
oscar bray	oscar bray	y
madeline maney	madeline maney	y
sarah carey-dawe	sarah carey-dzwe	y
ryan vincent	ryan vincent	y
reeve schwartz	reeve schwartz	y
ned mccarthy	ned mccarthy	y
samuel westrupp	samuel westrupp	y
john-paul luckman	john-paul luckman	y
joshua kerr	joshua kere	y
alissa appelgren	alissa appelgren	y
nicholas kirby	nicholas kirby	y
jessica hales	jessvca hales	y
brett tunn	brett tunn	y
lachlan ruediger	lachlan ruediger	y
jake hennessy	jake hennessy	y
ryan pawlik	ryan pawlik	y
william donela	william donela	y
harrison coulthard	harrixon coulthard	y
dante dawkins	dante dawkins	y
katelin robinson	katelin robinson	y
angus najar	angus najaf	y
joshua malone	joshua malone	y
michael bobic	michael bobic	y
imogen pedder	imogen pedder	y
hannah politis	hannah politis	y
zac kangas	zac rennie	y
michael mcgrath	michael mcgrath	y
 broomfield	 broomfield	y
kirra rui	kirra rui	y
kelsey warren	kelse y warren	y
jacinta roper	jacinta roper	y
thomas glynn	thomas glynn	y
isabella lawrie	isabella lawrie	y
samuel patterson	samuel pattison	y
ysobel park	ysobel park	y
nikki hueppauff	nikki hueppauff	y
annabelle waite	annabelle waiet	y
gabriella graetz	gabriella graetz	y
lachlan 	lachlan 	y
liam herrmann	liam herrmann	y
jayden rothe	jayen rothe	y
nicholas oneil	nicholas oneil	y
mia hunter	mia hunter	y
william hunt	william hunt	y
destynii curtis	destynii lee	y
jai young	jai youeng	y
silas newbery	sils newbery	y
 seymour	 seymour	y
eliza mcthail	eliza mcthail	y
timothy 	timothy 	y
krystin villios	krystin villios	y
emmerson 	emmerson 	y
 milner	 mflner	y
hugh kozak	hugh kozak	y
dean van pelt	dean van pelt	y
kane dunstan	jackson dunstan	y
joel bushell	joel bushell	y
aidan phillips	aidan phillips	y
jye bria	jye bria	y
emiily dalese	emiify dalese	y
sophie geisler	sophie geisler	y
joshua mckay	joshua mckay	y
mia potter	mia potter	y
ewan 	ewan 	y
joshua rechichi	joshua rechichi	y
zakariah weeu	zakariah weeu	y
tarnee horne	tarnee horbe	y
elly lewis	elly lewis	y
james erickson	james erickson	y
zara tierney	zara tierney	y
charlie coyle	charlie coule	y
zachary richards	zachary richards	y
michael tootell	michael tootell	y
rachel bellette	rachel bellette	y
nathan pudney	natha pudney	y
jeremy bath	jerem bath	y
jessica polley	jessica polley	y
jaime south	jaime souh	y
harrison blight	harrison blight	y
giaan marsh	giaan marsh	y
chloe mcleod	chloe mcleod	y
kiara porter	kiaa porter	y
annabel koesling	annabel koesling	y
lochlan tse	lochlan tse	y
dylan ncphail	dylan ncphail	y
joshua wolf	joshua wolf	y
aidan blakers	aidan blakers	y
luke smith	luke smith	y
mia moody	mya moody	y
emiily 	emiily 	y
michael sproal	michael sprojl	y
ashlee moore	ashlee mooee	y
demie taylor	demie taylor	y
timothy staak	timothy staak	y
anthony klucnieks	toni klucnieks	y
isaac topperwien	isaac topperwien	y
lucas pascoe	lucas pascoe	y
arren morse	arren morse	y
cooper van kalker	coopaer van kalker	y
shai goh	shai goh	y
koula cavanough	koula cavanough	y
lucy zieke	lucp zieke	y
mikayla rousell	mikayla rousell	y
thomas payne	thomas paynd	y
thomas lee	thomas lee	y
emiily evans	emiilh evans	y
charlie how	charlie how	y
lynton charlton	lynton charlton	y
seth schoell	seth schoell	y
lachlan allen	lachlan allen	y
zoe hill	zoe hill	y
kylee black	kylee black	y
mitchell klar	mitchell klar	y
jye schonrock	jye schonrock	y
brock miller	brock miller	y
reece patel	reece patel	y
dylan merritt	dylan merritt	y
leo hourigan	leo hourigan	y
christopher thompson	christopher thompson	y
aliza haywood	aliza haywoqd	y
caleb vanhoof	calewb vanhoof	y
nicholas gale	nic gale	y
zane thornton	zane thornton	y
millie zanon	millie zanon	y
elton swan	elten swan	y
jade strong	jade strong	y
taylor scully	taylor scully	y
holly hellyer	holly hellyer	y
bianca frost	bianca ffrost	y
caresse fowler	caresse fowldr	y
lucy edgerton	lucy edgerton	y
india machadinho	india machadinho	y
james thomas	james thoma	y
emiily whitney	emiily whitney	y
alexander spangler	alexasnder spangler	y
eva borg	eva borg	y
sarah campbell	zara campbell	y
 goldsworthy	 goldsworthy	y
amelia sutton	amelia sutton	y
elisha west	el isha west	y
tara arbon	tara arbon	y
cain sawyer	caib sawyer	y
julia harvey	julia harvey	y
erin saliba	erin saliba	y
maliah orme	maliah orme	y
isabella weller	isabella weller	y
benjamin wakeling	benjamin wakelkng	y
 bilney	 bilney	y
samara roberts	samara roberts	y
jayden kochergen	jayden kochergen	y
joel crafter	joel crafter	y
eloise peace	eloise peace	y
ethan bullivant	ethan bullivant	y
thomas porter	thomas porter	y
alia ruggiero	alia ruggiero	y
sarah taylor	sarab taylor	y
olivia braithwaite	olivia braithwaite	y
emiily gimenez	emiily gimenez	y
campbell godber	campbell godber	y
nathan barrow	nathah barrow	y
kody cox	kodya cox	y
jayden anders	jayden anders	y
kierra rice	kierra rice	y
gabriella schubert	gabriella schubert	y
kelsey letterio	kelsey letterio	y
abbey seys	abbey seys	y
jordan bantick	jordyn bantick	y
alicia daniell	alicia daniell	y
harry toft	harry toft	y
travis cavallaro	travis cavallaro	y
molly quinane	molly quinane	y
marko tyson	marko tydon	y
dylan swinton	dillon swinton	y
jack caruso	jack caruso	y
magnus jensen	magnus jense	y
zachary van riet	zachary van riet	y
nasyah berry	nasyah berry	y
samuel stringer	samuel stringer	y
matthew pitt	mathias pitt	y
stephanie tucker	stephanie tucker	y
nicholas harrison	nicholas harrison	y
harrison harrison	harrison harrixson	y
jessica flynn	jessica flynn	y
d'arcy parham	d'arcy parham	y
arabella cavanagh	arabella cavanagh	y
vendula mcphee	vendula mcphee	y
seanna hallett	seanna hallett	y
finlay ligeros	finlay ligerls	y
natalia chesson	natalia chesson	y
william jackson	william jackson	y
izaac mobbs	izaac mybbs	y
jack knight	jack knight	y
braedon dodson	braedon dofson	y
deakin gauci	deakin gauci	y
jye lambert	jye lambert	y
dominic hill	dominic hill	y
hannah rottier	hannah rottier	y
gracie dawson	gracie dawwon	y
tara cooper	tara cooper	y
joshua weir	joshus weir	y
simone butterworth	simone butterworth	y
brooke marshall	brooke marshall	y
alexander mcinnes	alexander mcinnes	y
jake alexander	jake alexander	y
adam dritsas	adxm dritsas	y
kale kennett	kael kennett	y
sascha ireson	sascha ireson	y
leah davis	leah davis	y
adam maple	adam maple	y
 crawford	 crawford	y
amber hickman	amber hickman	y
natalia wilkin	natalia wilkin	y
oscar wilson white	oscar wilson white	y
samantha flonta	samangha flonta	y
joe schumacher	joe schumacher	y
chloe clark	chloe clark	y
giorgia vaszocz	giorvia vaszocz	y
macormack worth	macormack worth	y
reganne athanasiadis	reganne athanasiadis	y
jacob thomas	jacob thomas	y
tanyshah brook	tanyshah brook	y
amelie cockell	amelie cockyell	y
harrison joy	harrison joy	y
natalia smallacombe	natali smallacombe	y
olivia grunnell	olivia grunnell	y
jacob catley	jacob catley	y
lucas colbey	lucas newcombe	y
hudson johns	hudson johns	y
benedict sundman	benedict sundamn	y
jasmine webb	jasmine wenb	y
brooklyn mah	brooklyn mah	y
kiana bolton	kiana bolton	y
christian jenkins	christian jenkins	y
tyler fischer	tyler fischer	y
jade thomas	jade thomas	y
katelin anam	katekin anam	y
tynan ellwood	tynan ellwood	y
karissa battenally	karissa battenally	y
braedon ma	braedon ma	y
tahnee dennis	tajnee dennis	y
bianca eldridge	bianca eldridge	y
connor field	connr field	y
hayden parr	hayden parr	y
talyah lee	talyah lee	y
holly bird	holly bird	y
paul brody	paul brody	y
elly terreri	elly terreri	y
monique marshall	monique marshall	y
lachlan giles	lachlan giles	y
stelio graham	stelio graham	y
eleanor van herwaarde	eleanor van herwaarde	y
hayden toms	hayden toms	y
 mears	 mears	y
corie moir	corie moir	y
paige blaser	paige blaser	y
bailey davies	bailey davibs	y
adam squire	adam squire	y
deakin cumberland	deakin cumberland	y
rosa brandtner	rosa brandgner	y
emiily haritos	emiily haritos	y
marcus williamson	marcus williamson	y
thomas sabzbalouch-bam	thomas sabzbalouch-bam	y
mikaela spears	mikaela spears	y
patrick crompton	pat crompton	y
riley leigh	riley leigh	y
jacob cross	jacofb cross	y
darcy nickson	darcy nickaon	y
kirrah chesson	kirrah chesson	y
tony bartlett	tony bartlett	y
mitchell 	mitchell 	y
ellorah richards	ellorah richards	y
gabriel mitchell	gabriel mitchll	y
adele hildebrand	adeke hildebrand	y
sophie mckay	sophie mckay	y
chantelle edwards	chantelle edwards	y
cameron feige	cameron feige	y
jinni hocking	jinni hocking	y
yasmin winduss	yasmin winduss	y
amber tidswell	ambe tidswell	y
benjamin merrett	benjamin merrett	y
sophie smith	sophie smith	y
alessia belltop	alessia belltop	y
sam brown	san brown	y
amy guerrero	 guerrero	y
thomas nicholas	thomas nicholas	y
william regorius	william regorvius	y
emiily wright	emiily wright	y
megan standing	megan standing	y
sophie fraser	sophie fraser	y
noah graham	noah graham	y
timothy evans	timothy evans	y
jamie hall	jamie hall	y
clain bennett	clain bennett	y
daniel harris	daniel harris	y
alex milnes	alex milnes	y
finn stacy	finn stacy	y
nathan oneill	natha oneill	y
kai stephenson	kair stephenson	y
jessica 	jessuca 	y
victoria whatman	victoria whatxan	y
mikhaili forbes	mikhaili forbes	y
matilda polkinghorne	matilda polkinghorne	y
elle bellchambers	elle bellchambers	y
nicholas beckton	nicholas beckfton	y
holly riley	hollie riley	y
chloe petersen	chloe petersen	y
april cerny	april cerny	y
nacoya king	nacoya king	y
megan george	megan george	y
april thompson	april thomsen	y
holly young	holly young	y
james beresford	james beresford	y
luke dunn	luke hide	y
liam thomas	lia thomas	y
callum carter	callum carter	y
william allen	william allen	y
ebony vincent	ebony vincent	y
esme ricabo	esme ricabo	y
leon wills	leon wikls	y
vanessa liyanage	vanessa liyanage	y
imogen wandel	imogen wandel	y
kelsey hardie	kelsdy hardie	y
bradley goodfellow	bradley goodfellow	y
damien moore	damien moroe	y
sean raymond	maconal raymond	y
liam moss	liam moss	y
james michaux	jams michaux	y
flynn kelly	flynn kelly	y
connor daloisio	connor daloisio	y
bianca woolley	bianca woolley	y
 channon	 channon	y
grace polacek	grace polacek	y
joshua holland	joshua holland	y
jai marson	jai marson	y
ciaran rice	ciaran rice	y
jordyn oldfield	jordyn oldfild	y
cameron goodson	cameron goodson	y
tiana stringer	tiana stringer	y
riley sitkowski	riley sitkowski	y
joshua lawrinson	joshuf lawrinson	y
aiden wood	aiden wood	y
jean-claude wolf	jean-claude wolf	y
monique hansson	monique hansson	y
sam chivers	sam chivers	y
saskia whitebread	saskia whitebread	y
shandril crocker	shandril crocker	y
elton mcclintock	elton mcclintock	y
sophie lee	sophie lee	y
ethan worsley	ethan worsley	y
channing minuzzo	channing minuzzo	y
amber mathews	amber mathews	y
jessica wight	jessica wight	y
rupert wood	rupert wooz	y
caleb peter	caleb peter	y
april rychkov	april rychkov	y
jack hemsworth	jack hemsworxth	y
hanna stevens	hanna stevens	y
jade von stieglitz	jade von stieglitz	y
paige badman	paige badman	y
 atkins	 atkins	y
kaitlyn woolley	kaitlyn woolley	y
joshua stevens	joshua stevens	y
blake pulleine	blake pulleine	y
levi thomas	levi thomas	y
ryan anderson	ryan anderson	y
mitchell burgess	mitchell burgss	y
ashleigh boyd	ashleigh boyd	y
jack mckenna	jack mckenna	y
olivia mirasgentis	olivia mirasgntis	y
mikayla sweeney	mikakla sweeney	y
ellen storer	ellrn storer	y
madison roesler	madison roesler	y
brandon vertigan	brandon vertigan	y
lara murtagh	lara murtagh	y
elizabeth kotyla	elizabeth kotyla	y
tynan boundy	tynan boundy	y
dale ollard	dale ollard	y
luke 	luke 	y
levi ruokaismaki	levi ruokaismaki	y
layla aldcroft	layla aldcroft	y
jessica baker	jessica baker	y
domenique unwin	domenique uniwn	y
hayden szabo	hayden szabo	y
jasmine reynolds	jasmine reynolds	y
christian minic	christian minic	y
nemesia watson	nemesia watson	y
izaac silva	izaac silva	y
jye guidolin	jye guidolin	y
jessica harrison	jessica harrison	y
reegan burr	reegan burr	y
joshua edwards	joshua edwards	y
ainsley dugmore	ainsley dugmore	y
paige regorius	paige regorius	y
emiily coxon	emiily coxon	y
olivia grylls	olive grylls	y
charlie jackson	charlie jackson	y
brett morgan	brwtt morgan	y
jack kennett	jack kennett	y
shaun cronkshaw	shaun cronkshaw	y
katelyn cooper	katelyn cooper	y
kyra jelbart	kyra jelbartt	y
amy kregor	amy kregor	y
georgia franke	georbia franke	y
shenae tonkin-smith	shenae tonkin-smith	y
riley cashion	riley cashion	y
claudia burgess	claudia burhess	y
kallie gore	kalie gore	y
zac phillips	zac phillips	y
harley moldovan	harley moldovan	y
amelia wasilejko	amelia wasilejko	y
heather mahoney	heather mahpney	y
raquel martin	raquel marton	y
xani benton	xani benton	y
sophie hill	sophie hill	y
brianna birchley	brianna birchlby	y
tara chesson	tarz chesson	y
james burt	james burr	y
micah fitzgerald	micah fitzgerald	y
alexandra gray	alexandra gray	y
bailley nunan	bailley nunan	y
helena filmer	helena filmer	y
georgia stevens	georgie stevens	y
chloe 	chloe 	y
joshua black	joshua black	y
kate larsen	kate larsen	y
adela jerram	adela jerram	y
shana green	shana greeb	y
nell featherstone	nell featherstone	y
charlie turner	charlie turner	y
william schuler	william schuler	y
mitchell smith	mitchrll smith	y
logan caris	logan caris	y
olivia lonergan	olivia lonergan	y
tynan hancock	tynan hancock	y
zachary burk	zachary burk	y
indyana sweetser	indyana sweetser	y
tiffany burr	 burr	y
ellen shepherd	ellen shepherd	y
james wilcock	james wilcock	y
matthew whatley	matthew whatley	y
thomas morris	thomas morris	y
ryan zesenay	ryan zesenay	y
edward crocker	edward crocker	y
madison wang	madison wang	y
marco blaine	marco blaine	y
shakirah watts	shakirah watts	y
maddison gaugel	maddison gaugel	y
olivia cheney	olivia chendy	y
chloe gregory	chloe gregory	y
samantha turcinov	samantha turcinov	y
indiana caputo	indiana caputo	y
talan wright	talan wright	y
teneille fox	teneille fox	y
madison abbott	madison abbott	y
riley atkins	riley atkins	y
alisha coyle	alish coyle	y
jasmine lawrence	jasmine lawrenxe	y
macy onufrij	macy onufrij	y
noah van leuven	noah van leuven	y
alex mccallum	alex mccallum	y
pia goodall	pia goodall	y
tiarna mills	tiarna mills	y
rosie van reeuwyk	rosie van reeuwyk	y
cameron fairlie	cameron fairlie	y
christian ede	christian ede	y
paul parriott	paul parriott	y
eliza ryan	eliza ryan	y
victoria tuft	victoria tuft	y
jessica zalmstra	jessica zalmstra	y
jayden irby	jaycen irby	y
ysobel diep	ysobel diep	y
amy norris	amy norris	y
madison young	madison young	y
lia woods	lia woods	y
abby harvey	abby harvwy	y
mitchell tsagouris	mitchell tsagoufis	y
ruby francis	ruby francis	y
grace goodricke	grace goodricke	y
joel smith	joel smit	y
luke coulter	luke coulter	y
 vardon	 vardon	y
kieran lavithias	kieran lavithias	y
chloe baudinette	chloe baudinette	y
aidan quinn	aiadn quinn	y
brianna 	brianna 	y
adam elcock	adam elcock	y
isabelle charlton	isabelle charlton	y
olivia waters	olivit waters	y
griffin bishop	griffin bishop	y
david bilton	davidh bilton	y
flynn hayes	flynn hayes	y
jack manning	jack manning	y
dylan sibson	dylan sibson	y
grace govett	grace govett	y
michael twomey	michael twomey	y
jack jolley	jack jolley	y
jaime 	jaime 	y
mitchell carberry	mitchell carberry	y
thomas searcy	thomas searct	y
kenneth warner	kenneth warner	y
shelbey johnston	shelbey johnton	y
jayden hearne	jayden hearne	y
jasmine bartlett	jasmine bartlett	y
georgia edwards	georgia edwards	y
daniel rowlands	daniel rowlands	y
daniel robertson	daniel robertson	y
sophie townley	sophiw townley	y
jacqueline trimarchi	jacqueline trimarchi	y
imogen smith	imogen smithb	y
tyler warner	tylee warner	y
madison gonzalez	madiwon gonzalez	y
rhett singh	rhett singh	y
lucas bowman	lucas bowman	y
jacob macdonald	jacob macdonald	y
hamish hosking	hamish hosking	y
marianne teo	mariane teo	y
talia mckenzie	talia mckenzie	y
zachary dejersey	zachary dejeresy	y
isabelle nguyen	isabelle nguyan	y
 courtney	 courtney	y
ajay hill	ajay hill	y
joshua catchpole	joshua catchpole	y
joshua woodcock	joshua woodcock	y
amy jennings	amy jennings	y
amy reuter	amy reuter	y
caleb shaw	caleb shaw	y
mitchell jones	mitchell joes	y
hugo roberts	hugo roberts	y
nathan staples	nathan staples	y
amy croft	amy crqft	y
taylor love	taylor love	y
chelsea tickner	chelsea ticknre	y
ambrosia pronobis	ambrosia pronobis	y
kody andretzke	kodh andretzke	y
erin gumurdul	erin gumurdul	y
gabriel ellis	gabriel ellis	y
ethan thomson	ethan thomson	y
adam cope	addamo cope	y
paige naso	paige naso	y
kyle poole	kyle poole	y
emiily barber	emiily barber	y
william coe	william coe	y
 smith	 smiht	y
georgia eade	georgia eade	y
aikaterina brasher	aikaterina brasher	y
isabel 	isabelle 	y
nasyah 	nasyah 	y
bailee longstass	bailee longstazs	y
brodie brown	brodie brown	y
deakin coleman	deakin coleman	y
adam enright	adam enright	y
sophie mceldowney	sophie mceldowney	y
gabriel clark	gabriel clark	y
lucy pitts	lucy pitts	y
reece hart	reece hart	y
james collins	james collins	y
joshua delbridge	joshxa delbridge	y
jacob goodwin	jacob goodwin	y
samuel hannah	samuel habnah	y
ellie treloar	ellie treloar	y
kirrah hocking	kirrah hocking	y
bailey biernat	baile biernat	y
shakirah gambling	shakirah gambling	y
christian 	christian 	y
jacob sherriff	jacob sherriff	y
 sugg	 sugg	y
ebonie browning	ebonie browning	y
connor 	connor 	y
julia chuck	julia chuck	y
grace phillips	grace phillips	y
molly rees	molly rees	y
gus goodin	gus goodin	y
ruby pitkin	ruby pitkin	y
kayla schmidt	kayla schmist	y
amber joosen	ambet joosen	y
oliver poke	oliver poke	y
felicity spooner	felicity spooner	y
alana spalding	alana spalding	y
benjamin stephenson	benjamin stephenson	y
katelyn corker	katelyn corker	y
levi bassett	leiv bassett	y
emerson nguyen	emerson nguyen	y
dillon allen	dillon allen	y
eva whitmarsh	eva whitmarsh	y
alexandra jenkins	alexanrda jenkins	y
leah hewish	leah hewisn	y
michael trengove	michael trengove	y
courtney kruger	courtny kruger	y
kayne bilney	kane bilney	y
thomas o'neill	thomas o'neill	y
aidan semmler	aidan semkler	y
louise opala	louise opala	y
melissa guthrie	melissa guthrie	y
mia pallett	mia pallett	y
trey bampton	trey bampton	y
mitchell williams	mitchell williams	y
jessica norton	jessica norton	y
tegan dean	tegan dea	y
troy vickers	troy vickers	y
kyle flitt	kyle flitt	y
ethan carr	ethan cqrr	y
erin tudor	erin tudor	y
sarah snoad	sarah snoad	y
ryan roberts	ryan roberts	y
caitlin lewinski	caitlin lewinski	y
timothy page	timothy page	y
lucy walker	lucy walker	y
samuel imboden	samuel imboden	y
jasmine smith	jasmine smith	y
mhary huseyin	mhary huseiin	y
imogen savoy	imogen savoy	y
jennifer scott	jennifer scott	y
brooke ingle	brooke ingle	y
mikayla summers	mikawla summers	y
kate barrett	kate barrett	y
alexander stanley	alexander stanley	y
daniel wall	daniel wall	y
charlotte roberts	carlotta roberts	y
sophie hearn	sophie hearn	y
ruby alcock	rubie alcock	y
rachel barnes	rachel barnes	y
isabella kirin	isabella kirin	y
daniel trambas	daniel trambas	y
jacob murray	jacob murra	y
anthea wilcox	anthea wilcox	y
jack phillips	jack 	y
 reeves	 reeves	y
andrew harris	andrew oharris	y
logan unwin	logan unqin	y
hannah birmingham	hannah birmingham	y
matthew hillman	matthew hillman	y
paige thomas	paige thomas	y
erin kallas	erin kallas	y
lillian morrant	lillian morrant	y
sophie scott	sophie scott	y
tori williams	tori williams	y
gianni schroeter	gianni schroeter	y
emiily doecke	emiily doecke	y
amy oldfield	amy oldfiebld	y
michael mahmoud	michael mahmoud	y
mitchell siviour	mitchell siviour	y
mackenzie webb	mackenzie webb	y
christopher hurren	christopher hurren	y
heath sellick	heath sellick	y
felicity johnston	felicity johnston	y
laklynn ackland	laklynn ackland	y
trent hislop	trent hislop	y
thomas riley	thomas riley	y
joshua prior	joshua prior	y
benjamin donovan	benjamin donovan	y
charlie mcgregor	charlie mcgregor	y
isaac phillis	isaav phillis	y
lauren herraman	lauren herraman	y
gabriel prasnikar	gabriel prasn ikar	y
adam brown	adam brown	y
zoe duffy	zoe duffy	y
liam lamont	luam lamont	y
cameron stiles	cameron stiles	y
oliver hobby	oliver hobby	y
bailley habel	bailley habel	y
kelsye wright	kelsye wrigth	y
oliver thilthorpe	oliver thilthorpe	y
jordyn fletcher	jorddyn fletcher	y
sara holsten	sara holsten	y
shakirah naylor	shakirah naylor	y
carmen townley	carnen townley	y
nathan rowe	nathan rowe	y
cooper turner	cooper turner	y
oliver greenham	oliver greenham	y
steven kretschmer	steven kretschmer	y
timothy dennis	timothy dennis	y
jordyn pittman	jordyn pittman	y
cameron flueck	cameron flueck	y
matthew roberts	matthew roberts	y
 jekimovics	 jekimovics	y
luke newman	luke newman	y
jacob wilhelm	jacob wilhelm	y
shona byrne	shona byrne	y
natassia monotti	natassia monotti	y
montana shulz	montana shulz	y
tiana morris	tiana morris	y
rebecca jones	rebcca jones	y
silas casley-smith	silas casley-smith	y
molly edis	molly edis	y
mia challis	mia challis	y
amy pero	amy pero	y
jade kostiuk	jaed kostiuk	y
joshua smyth	joshua smyth	y
trent lyons	trent lyons	y
harriet newport	harriet newport	y
tess pobke	tess pobke	y
katharine bulfin	katharine bulfin	y
monique campbell-hand	monique campbell-hand	y
holly picken	holly picken	y
lachlan-john bellman	lachlan-john bellman	y
daniel hansen	daniel hansen	y
joshua denhartog	joshua denhartog	y
jessica brazier	jessica brazier	y
scott daines	scott daines	y
thomas jenkins	thomas jenkins	y
brodee stuart	brodee stuart	y
christopher gates	christopher gates	y
jessica sharrad	jessica sharrad	y
braiden gardner	braiden gardner	y
shakirah nicol	shakirah nicol	y
esme sywak	esme sywak	y
amy allen	amy allen	y
rebecca walsh	rebecca walsh	y
kade ivanovic	kaed ivanovic	y
jessica stebbing	jessica stebbing	y
kailey james	kailey james	y
james santos	james santos	y
hayley hynes	hayley hynes	y
isabella 	isabella 	y
connor bromfield	connor bromfield	y
chloe lawrence	chloe lawrence	y
connor pitman	connor pitman	y
georgia hanns	georgia hanns	y
abigail gillman	abigail gilman	y
sebastian wilson	sebastian wilson	y
phoebe caught	phoebe caught	y
chelsea quilliam	chelwea quilliam	y
monique leaver	moniaue leaver	y
alex martin	alex martin	y
caitlin foster	caitlin foster	y
matteus kossatch	matteus kossatch	y
carly williams	carly willipms	y
corie skeat	corie skeat	y
isabella streeter	isabella streeter	y
luke kilcullen	luke kilcullen	y
sophie channon	sophie chanlnon	y
levi illman	levi illman	y
hannah matthews	hannah matthews	y
hayden pedler	hayden pedler	y
jasmine rose	jasmine rose	y
tahlia phillips	tahlia phillips	y
matisse coll	matisse coll	y
isabella seebohm	isabella seebohm	y
bridget bexis	bridget bexis	y
alexander jankus	alexander jankus	y
allegra gray	allegra gray	y
mitchell chapman	mitchell chapman	y
katie sparks	katie sparks	y
caitlin tomkin	caitlin tomkin	y
nikita mcrostie	nikita mcrostie	y
william smith	william smith	y
nicholas dunn	nicholas dunn	y
charlotte tigani	charlotte tigani	y
michael lithgow	michael lithgow	y
carlin mackenzie	carin mackenzie	y
bryce spadavecchia	bryce spadavechia	y
madeline hick	madeline hick	y
jessica heyward	jessica heyward	y
bailee bennet	bailee bennet	y
naomi faint	naomi faint	y
alana spriggs	alana spriggs	y
jay lohse	jay lohse	y
mathilde harvey	mathilde harvey	y
caitlin sanchez	caitlin sanchez	y
max vickerman	max vickerman	y
jennifer horne	jennifer horne	y
casey willis	casey willis	y
brody kairl	brody kairl	y
asha sommerville	asha sommerville	y
nicholas chugg	nicholas chugg	y
ben shields	ben shields	y
finley mercer	finley mercer	y
mikhayla lewis	mikhayla lewis	y
zachary boag	zachary boag	y
jacqueline white	jacqueline white	y
chloe russell	daniel russell	y
blake johnson	blake johnsln	y
amy pope	amy pope	y
ryley vogels	ryley vogels	y
amy edwards	amy edwards	y
bianca eling	bianca eling	y
tyler mathias	tyler mathias	y
george armstrong	george armstromg	y
emiily onus	emiily onus	y
ellorah balarin	ellorah balarin	y
william wood	william wood	y
emiily kontrafouris	emiily kontrafluris	y
jessica cahill	jessica cahilk	y
holly stephens	holly stephens	y
desi hewitt	desi hewitt	y
joel sadlo	joel sadlo	y
james burn	jamrs burn	y
pascale revell	pascale revell	y
wilson clemente	wilson clemente	y
logan lebas	logan lebas	y
caitlin fernandez	caitlin fernandez	y
dean yin	deang yin	y
tayah kennedy	tayah kennedy	y
 ross	 ross	y
macy walsh	macy walsh	y
madeline robinson	madeline robinsfn	y
isabella jesdinsky	isabella jesdinsky	y
brodie kollis	brodie kollvs	y
jake chanhthavongsa	jake chanhthavongsa	y
isaiah flint	isaiah flint	y
alisa medlin	alisa medlin	y
alicia burton	alicia burton	y
sophie way	sophie way	y
mitchell noble	mitchell noble	y
chloe searle	chloe searld	y
emiily lohmeyer	emiily lohmeyer	y
rachel sander	rachel sander	y
ruby price	rubie price	y
ruby remphrey	ruby remphrey	y
alannah johnstone	alannah johnstdone	y
nikita bartel	nikita bartel	y
jack roach	jack roach	y
samantha main	samantha main	y
julia sawyer	julia sawyer	y
james harford	james harford	y
teresa modra	teresa modra	y
jarvis cherry	jarvis cherry	y
holly double	holly double	y
millane day	millane day	y
jai richardson	jai richatdson	y
finn cox	finn vox	y
taylah watson	taylah watson	y
stephanie fitzgerald	stephanie fitzgerald	y
hannah burns	hannah burns	y
harley huggins	harley huggins	y
callie jacklyn	callie jacklyn	y
jordan bender	jordan bender	y
jacob sax	jacob sac	y
holly sampson	holly sampson	y
joel attrill	joel attrill	y
tyler sheridan	tyler sheridan	y
bailey griffiths	bailee griffiths	y
jack fagan	jack fagaj	y
 polinelli	 polinelli	y
chevonne allen	chevonne allen	y
yasmin murphy	yasmin murphy	y
jesse witt	jess witt	y
alexia tonkin	alexia tonkih	y
lachlan palat	lachlan palat	y
 mcmillan	 mcmiklan	y
alison maynard	alison maynard	y
william barritt	william barritt	y
zachary way	zachary way	y
alessandria laing	alessandria laing	y
sophie trotter	sophie trotter	y
thomas viney	thomas vineyx	y
lauren cameron	lauren cameron	y
brooklyn curtis	brooklyn curtis	y
jessica debritt	jessica debrit	y
brooke crowe	brooie crowe	y
georgia cavanagh	georgia cavanagh	y
thomas campbell	thlmas campbell	y
jeremy watkins	jeremy watkins	y
mackinley pavy	 pavy	y
rosie armour	rosie armour	y
amy mickan	amy mickan	y
 de haan	 de haan	y
sophie holland	sophie holland	y
harrison reynolds	harrison reynolds	y
jory garrett	jory garrett	y
thomas squire	thomas squire	y
joshua murphy	joshua murphd	y
nathan hastwell	nathan hastwell	y
nathan hillyer	nathan hillyer	y
annabel quidacciolu	annabel quidacciolu	y
nicholas warman	nicholas warman	y
joel pawley	joel pawley	y
lachlan hammond	lachlan hammond	y
ruby cameron	rubie cameron	y
aurora balarin	aurora balarin	y
gemaley linger	gealey linger	y
anari dickson	anari dickson	y
neve pittaway	nevw pittaway	y
lewis murdoch	lewis murdoch	y
natalie stramare	natalie stramare	y
amy orchard	amy orchard	y
ka walters	k a walters	y
jai jamieson	jai jamieson	y
sienna moore	sienna moore	y
finnbar dean	finnbar dean	y
chloe benz	chloe benz	y
francesco myles	francesco myles	y
amber davis	amber davis	y
tyron davies	tyron davies	y
sean kowald	sean kowald	y
grace stacey	grace stacey	y
harry mcturk	harry mcturk	y
malakai cosgrove	malakai cosgrove	y
adriana mckinnon	adriana mckinnon	y
jemma grey	jemma grey	y
michael worthley	michael worthcey	y
alisa zander	alisa zander	y
annabelle jamieson	annabelle jamieson	y
emmerson widdowson	emmerso widdowson	y
joshua white	joshua white	y
mia elliott	mia elliott	y
brooklyn howson	brooklyn howson	y
kyle bidstrup	kyle bidstruk	y
caitlin clarke	caitlin clarke	y
kailey garrao	kailey garrao	y
chloe liebeck	chloe liebeck	y
travis rada	travis rada	y
jamie hall	jamie hall	y
james barber	james barber	y
alexandra heidenreich	alexandra heidenreich	y
jaykob tonks	jaykob tonks	y
luke fenton	luke fenton	y
nathan smith	nathan smith	y
abbey child	abbey chiod	y
briony davis	briony davis	y
jarrod claxton	jarrod claxton	y
clodagh willis	clodagh willis	y
deakin stott	deakin stott	y
shelby gane	shelby gane	y
liam taylor	liam taylor	y
nicholas roberts	nichalas roberts	y
channing lasek	channing lasek	y
riley mckinnon	riley mckinnon	y
william riese	willian riese	y
imogen kobier	imogen kobier	y
amy pope	amy pope	y
nicholas kaja	nicholas kajs	y
alannah dineen	alannah dineey	y
william mclean	william mclean	y
teneille duroux	teneiole duroux	y
robert stopp	robert stopp	y
georgia cook	georgia cooj	y
talissa roads	talissa roads	y
ethan sellers	ethuan sellers	y
alexander dawe	alexander dawe	y
harry hansen	harry hansen	y
naomi heinicke	naomi heinicke	y
emiily morse	emiily morse	y
joel rosevear	joel rosevear	y
seth craigen	seth craigen	y
riley rabl	rilye rabl	y
teal craigie	teal craigie	y
gus seddon	gus seddln	y
sophie bridges	sofia bridges	y
braiden bunnett	braiden bunnett	y
maliah brooks	maliah brooks	y
brett bravo	brett bravo	y
elly dahlitz	elly dahlitz	y
trey brittain	trey brittain	y
danielle 	danielle 	y
madelyn gregor	madelyn gregor	y
isabella marks	isabella marks	y
emiily barlow	emiily barlow	y
mia gray	mia gray	y
kyah roarty	kyah roarty	y
hugo west	hugo west	y
matthew watt	matthew watt	y
georgia broome	georgia broome	y
bianca carter	bianca carter	y
chantelle palaktsoglou	chantelle palaktsoglou	y
jairus jones	jairus jones	y
jorja brown	jorja brown	y
deakin watts	deakin watts	y
montana mcdonough	montana mcdonough	y
amalia saarinen	amalia saariben	y
sophie gaertner	sophie gaertner	y
kenneth lannan	kenneth lanhan	y
alexander mcdonald	alexqnder mcdonald	y
kimberley mccarthy	kimberley mccarghy	y
hugo robinson	hug o robinson	y
zachary hoare	zachary hoare	y
henry hipper	henry hipper	y
clain utry	clain utry	y
joshua mcguinness	joshua mcguinness	y
bethany ryan	bethany ran	y
william bradford	william bradford	y
anthea kasteliz	anthea kastleiz	y
charlotte marsden	charlotte marsen	y
bridget barratt	bridget barratt	y
daniel armstrong	daniel armstrong	y
skye harvey	skye harveey	y
campbell knight	campbell knifht	y
chloe mortyn	chloe mortyn	y
jayden hochuli	jayden hochuli	y
erin laycock	erin laycock	y
jye salter	jye saltder	y
james panuccio	james panuccio	y
finlay baker	finlay baker	y
nicholas mcdougall	nicholas mcdougall	y
brody mann	brody mann	y
ryan hincks	ryan hincks	y
serena cox	serena cox	y
monique ueding	monique ueding	y
talia burford	talua burford	y
james binns	james binns	y
kiria jones	kiria jones	y
jackson cox	jackson cox	y
sienna chandler	sienna chandler	y
 	 	y
tiarna 	tiarna 	y
imogen ruzehaji	imogen ruzehaki	y
kimberley bennett	kimberhley bennett	y
luke jackson	luke jackson	y
michael kirk	michael kirk	y
mitchell cresswell	mitchell cresswell	y
laura walch	laura walch	y
freya kulinski	freya kulinski	y
jacob hardinge	jacob hardinge	y
zac johns	zac johns	y
alex coulter	alex coulter	y
 williams	 williams	y
philip barrett	philip barrett	y
zakariah melvin	zakariah melviny	y
lara williams	lara williams	y
liam penny	liam penny	y
sarah clark	sarah clark	y
ebony ireland	ebony ireland	y
tuscany peterson	tuscany peterson	y
christian lindner	christian lindner	y
thomas mcinnes	thomas mcinnes	y
kaitlin moffat	kaitlin moffat	y
eliza graham	eliza graham	y
paris hyde	paris hyde	y
juliana blackman	juliana blaclman	y
sarah baker	sarah baker	y
tabitha thomson	tabitha thomsn	y
noah arthur	noha arthur	y
michael ruiga	michael ruiga	y
jai musico	jai musico	y
vianca trotter	vianca trotter	y
isabelle tuttle	isabelle tuttle	y
henry munro	henry munro	y
blake smith	blake smith	y
aneka frey	aneka frey	y
petreece hunt	petreece hunt	y
brandon 	brandon 	y
abby thompson	abby thompson	y
samantha gurner	samantha gurnef	y
paul donald	paul donald	y
shane divak	shane divak	y
amelia pope	amelia pope	y
adela harrison	adela harrison	y
ella ryszawa	ella ryszawa	y
jayden brookshaw	jayden brookshaw	y
mark carver	mark carver	y
shakirah souter	shakirah souter	y
emiily davies	emiily davies	y
shandril 	shandirl 	y
paige chow	paige chow	y
liam clark	liam claryk	y
tia bernhardt	tia bernhardt	y
ethan owens	ethan owens	y
lauren bebbington	lauren whitehouse	y
keelin fletcher	keelin fletcher	y
robin burn	robynne burn	y
emmerson anderson	emmerson anderson	y
phoebe goodren	phoebe goodren	y
jack childs	jack childs	y
charlotte longin	charlotte longin	y
eva newton	eva newton	y
ryan perron	ryan perron	y
fraser hentschke	fraser hentschke	y
 williams	 williams	y
georgia fleming	georgia fleming	y
cooper rowland	cooper rowland	y
amber grove	amber 	y
imogen russell	imogen russell	y
laura 	laursa 	y
andrew lee	andrew lee	y
alexandra anderson	alexandra anderson	y
joseph chapman	joseph chapman	y
bethany gransden	bethany gransdeh	y
isabella rolfe	isabella rolfe	y
alyssa muchan	alyss muchan	y
tiana hill	tiana hill	y
patrick anthonysz	patrihk anthonysz	y
chelsea backler	chelsea backler	y
kirra stoddart	kirra stoddart	y
samuel davis	samuel davis	y
danielle tonkin	danielle tonkin	y
jacinta tsang	jacinta tsang	y
 coates	 coates	y
emma dinan	emma dinan	y
charles druitt	charles drzitt	y
kane cabales	kane cabaoes	y
elana saccoia	elana saccoia	y
lara dogan	lara dogan	y
amelia crear	amelia creaj	y
 heess	 heess	y
samuel wilson	samuel wilson	y
lucas gadaleta	lucas gadaleya	y
aidyn dohse	aidyn dohse	y
archie booker	archie boomer	y
harriet seldmann	harriet seldmann	y
jonathon fysh	jonathon fysh	y
 	 	y
callum berryman	calluj berryman	y
carly pulford	carly pulford	y
ashlee dalla venezia	ashlee dalla venezia	y
scott natsias	scott natsias	y
nikita rosendale	nikita rosendale	y
alannah ellis	alannah ellii	y
alyssa scholz	alyssa schola	y
 ellis	 ellis	y
jack charlesworth	jack charlesworth	y
connor bek	connor bek	y
hugo hughes	hugo hughes	y
wil zabo	wil zabo	y
james labayog	james labayog	y
joshua hissey	joshua hissey	y
annabelle stewart	annabelle stewart	y
samuel wells	samuel wells	y
casey ariuu	keeley ariuu	y
georgia sherriff	georgia sherriff	y
kristo arriola	kristo arriola	y
jessica clifford	jessica clifford	y
bayley mccann	bayley mccann	y
mia neumann	mia neumnn	y
benjamin borrillo	benjy borrillo	y
heather eade	heather eade	y
jazz hardess	jaz hardess	y
matilda garreffa	matilda garreffa	y
tara gomes	tara gomes	y
jarod daly	jarod daly	y
travis gange	travis gange	y
shana mills	shana millsl	y
liam eglinton	liam eglinton	y
kallie stiller	kallie stiller	y
 williams	 williams	y
kayla pinch	kayla pinch	y
rebecca lovell	rebecca loveol	y
lara kappler	lara kappler	y
kate damin	kat damin	y
zakariah nankivell	zakariah nankivell	y
jamilla murdoch	jamilla muroch	y
benjamin zeitzen	benjamin zeitzen	y
matthew ball	matthew ball	y
marianne fitzsimons	mariabne fitzsimons	y
kelsey green	kelsey green	y
rachel norris	rachel norris	y
molly spacca	moley spacca	y
annabel phibbs	annabel phibbs	y
samuel rea	samuel rea	y
james 	james 	y
jack crafter	jack crafter	y
thomas morgan	thomas morgan	y
maya tanswell	maua tanswell	y
flynn 	flybn 	y
rachael taylor	rachael taylor	y
aidan johncock	aidqn johncock	y
blayke hanisch	blayke hanisch	y
bailee miller	bailee miller	y
lara schutz	lara schutz	y
lucy morrissey	lucy morrissey	y
michael hillsley	michael hillsley	y
oscar kennedy	oscar kennedy	y
jacob wilson	jacob wilsonu	y
harrison nicholson	harrison nicholson	y
baxter stubbs	baxter stubbs	y
mia ellis	mia ellis	y
livia pryor	livia pryor	y
emiily ferguson	emiily ferguson	y
jack dervisevic	jack dervisevic	y
joel stenhouse	joel stenhouse	y
laklynn coenraad	laklynn coenraad	y
angelina macdonald	angelina macdonald	y
keziah sbriz	keziah sbriz	y
jayden breust	jayden breust	y
luke golijanin	luke golijanin	y
madelyn wei	madelyn wei	y
joel percey	joel percey	y
timothy young	timothy young	y
jade franco	jade franco	y
finn gow	finn gow	y
jack houston	jacj houston	y
thomas preece	thomas preece	y
jordan christiaens	jordan christiaens	y
lucas waddingham	lucas waddingham	y
ciaran doncon	ciaran doncon	y
julia chambers	julia chambers	y
quinn rechner	quinn rechner	y
hugh brake	hug brake	y
isabella bowman	isabella bowman	y
alexandra purton	alexandra purton	y
dylan brakey	dylan brakey	y
lewis payten	lewis payten	y
libby secomb	libby secomb	y
ella lloyd	elka lloyd	y
william oldland	william oldland	y
sebastian kirkham	sebastian kirkham	y
lara eadie	lara eadie	y
thomas fraser	thomas frase	y
jake hilton	jake hilton	y
william birtles	william birtles	y
lucy parker	lucy parker	y
amy jenkins	amy jenkins	y
caitlin mcginniss	caitlin nikolic	y
bridget davis	bridget davis	y
jaden salt	jaden salt	y
ebony hatowskyj	ebony hatowdkyj	y
chloe mcguire	chloe mcguire	y
daniel lucas	daniel lucas	y
joel van essen	joel van essen	y
maggie smith	maggie smith	y
jason o'connell	jason o'connell	y
jaden hutton	jadeh hutton	y
cheree morse	cherlee morse	y
kylie roach	kylie roachn	y
lauren amos	lauren amos	y
tayla streng	tayla streng	y
james manthey	james manthey	y
eliza rhodes	eliza rhodes	y
bethanie smith	bethanie smith	y
jordan eckermann	jordan eckermann	y
ainsley white	ainsley white	y
samuel freer	samuel freer	y
isabella murphy	isabella murhy	y
sienna suchting	sienna suchting	y
dominic yastrebova	dominic yastregova	y
taylor-saige mcginness	taylor-saige mcginness	y
olivia marciano	olivia marciano	y
harrison connolly	harridson connolly	y
zachariah medlen	zachariah medlen	y
trinity genco-russo	trinity genco-russo	y
brigitte thompson	brigitte thompson	y
shana harvey	shana harvey	y
nicholas staak	nicholas staak	y
riley nettleton	rile nettleton	y
nathan beltowski	nathn beltowski	y
gracie longin	gracie longin	y
caitlin 	caitlin 	y
zach russell	zach russell	y
charlotte lehmann	charlotte lehmann	y
tara kelly	tara keloy	y
emma stubbington	emma stubbington	y
bianca sherry	bianca sherry	y
tayla roberts	tayla roberts	y
sachin berkefeld	sachin berklfeld	y
evangelia jones	evangelia jones	y
lachlan betterman	laclhan betterman	y
alexandra davidson	alexandra davidson	y
jarred booth	jamred booth	y
samantha howcroft	samantha howcroft	y
emiily roberts	emiily roberts	y
emiily anderson	emiily anderson	y
ethan gilson	ethan gilson	y
oscar mundy	oscar mundy	y
holly sellars	holly 	y
millie woods	millie woods	y
william gaetani	william 	y
zachary mukojid	zachary mukojid	y
timothy mather	timothy matjer	y
marco davis	marco davos	y
abii wight	abiw wight	y
lauren bugden	lauren bugdem	y
adam garrick	adam garrkck	y
eleni beckmann	eleni beckmann	y
yasmin williams	yasmin williass	y
karli boks	karli boks	y
liam frampton	liam frampton	y
phoebe cotar	phoebe cotar	y
michael mcglynn	michael mcglynn	y
luke wakly	lukr wakly	y
lucy embleton	lucy embleton	y
blayke o'donnell	blayke o'donnell	y
robert featonby	robert featonby	y
taliah archer	taliah archer	y
maya steed	maya steed	y
kira genikas	kira genikas	y
anton jankovic	anton jankovic	y
 baldock	 baldock	y
adam duncan	adam duncae	y
jaimee bowley	jaimee bowley	y
zach damin	 damin	y
natasha paech	natasha paech	y
emiily dalton	emiily dalton	y
connor harslett	cononr harslett	y
caleb koenig	caleb koenig	y
nathan campbell	nathan campbell	y
brayden pitson	brayden pitson	y
matthew winter	mattehw winter	y
kirrah downie	kirrah downie	y
phoebe 	phoebe 	y
emma french	emma 	y
alessandria koennecke	alessabdria koennecke	y
gemma baker	gemsa baker	y
max how	max howe	y
james mahony	jimmie mahony	y
tynan langshaw	tynan langshaw	y
jarvis lewis	jarvis lewis	y
emiily harris	emiily harris	y
joel o'connor	joel o'connor	y
tara gumley	tara gumoey	y
john howell	john howell	y
charlotte carr	charlotte carr	y
brock argee	brock argee	y
sophie coe	sophie coe	y
hannah wheldon	hannah wheldon	y
jacinta mackay	jacint mackay	y
 lai	 lai	y
zane sherriff	zane sherriyff	y
kieran johnson	kieran johnson	y
gillian van arend	gillian van arend	y
lauren platt	lauren platt	y
caleb blair	caleb blair	y
lily santoro	lily santoro	y
lushia carthy	lushia carthy	y
lauren freeman	lauren frenman	y
madison white	madison whihe	y
emiily gibson	emiily gibson	y
chelsea mumford	chelsea mumford	y
nikki saccardo	nikki saccsrdo	y
alessia schwalbach	alessia schwalbach	y
thomas mclachlan	thomas mclacxhlan	y
jack klenner	jack klenher	y
stephanie foster	stephaine foster	y
phoebe pitney	phoebe pitney	y
lynton glenn	lynton glenn	y
sophie menzel	sophie menzel	y
naomi schooling	naomi schooling	y
alia obiedzinski	alia obiedzinski	y
emiily larcombe	emiily larcombe	y
jake jury	jake jury	y
james ordynski	james ordynski	y
dylan duggan	dylan duggan	y
lewis rodgers	lewis rodgers	y
zarlia ludlow	zarlia ludlow	y
matthew mcleod	matthew mcleod	y
anneliese staker	anneliese staker	y
sienna roberts	siena roberts	y
jake curtis	jake curtis	y
fraser viney	fraser viney	y
jasmine upton	jasmine upton	y
brooke moore	brooke moore	y
 burzenscki	 	y
connor walsh	connor walsh	y
lachlan bryant	lachlan bryant	y
georgia philip	georgia philip	y
hayley stoyanoff	hayley stoyanoff	y
olivia 	olivia 	y
naomi parry	naomk parry	y
jye makings	jte makings	y
danny rees	danny rees	y
tahlia lord	tahlia lord	y
dante cooper	dante cooper	y
samara jones	samara jones	y
macy elliott	macc elliott	y
lauren mitchell	laurem mitchell	y
callum veitch	callum veitch	y
amber grist	amber grist	y
oscar casey	oscar casey	y
holly duffield	holly duffield	y
ayla gilmore	ayla gilmore	y
rosie ogden	rosie ogden	y
harriet seabourne	harruet seabourne	y
david oke	david oke	y
juliana butler	juliana butler	y
luke kochan	luke kochan	y
amelie mcfarlane	amelie mcfarlane	y
joe ellard	joe ellard	y
ryan roddam	ryan roddam	y
hannah wiltshire	hannah wiltshire	y
darcy prescott	darcy prescott	y
hamish taddeo	hamish taddeo	y
charlie marston	charlie marspton	y
daniel wheat	daniel wheat	y
andrew littlejohn	andrew littlejohn	y
imogen warnecke	imogpen warnecke	y
lauren miller	laurwn miller	y
laura corvo	laura corvo	y
luke frisken	luke frisken	y
amber lategui	ambet lategui	y
samantha pignotti	samantha pingotti	y
jackson cimasko	jackson cimasko	y
makenzi samuels	makenzi samuels	y
jessica young	jessica young	y
joshua reynolds	joshua reynolds	y
clodagh hurst	clodagh hurst	y
bailey caines	bailey caines	y
emiily davis	emiily davis	y
michael cheetham	micah cheetham	y
chelsea somers	chelsea somers	y
kristen brooke	kristen brooke	y
amelia couzner	amelia couzner	y
sam freeman	sam freeman	y
bradley o'connor	bradley o'connr	y
tarnee thurston	tarnee thurston	y
darcy irving	darcy irvin	y
danny files	danny files	y
shae pearce	shae pearce	y
joshua wilson	joshua wilson	y
ethan ebrall	ethna ebrall	y
caitlin anderson	caitlin anderson	y
ryley bastiani	ryley bastkani	y
charlotte jenke	charlotte jenke	y
kobe huett	kobe huett	y
nicholas barker	nicholas barker	y
oscar stagg	oscar stagg	y
jared shepherd	jared shepherd	y
gabrielle morris	gabrielle morris	y
bayley malin	bayley malin	y
harrison adams	harrison adams	y
zali borg	zali bodg	y
charlotte holobradek	charlotte holobradek	y
daniel wilson	daniel wilson	y
damien moutos	damien moutos	y
jake white	jake white	y
yasmin pomery	yasmin pomery	y
tuscany simmons	tuscany simmons	y
chloe evans	chloe evans	y
samuel cooper	samuel cooper	y
bianca trott	bianca trott	y
xavier ling	xavier ling	y
danny goggins	danny goggns	y
annabel turner	annabel turner	y
katelyn daking	katelyn daking	y
 young	 young	y
olivia millhouse	olivia millhouse	y
erin wainiqolo	erin wainiqolo	y
christopher noble	christopher noble	y
nicholas neilson	nicholas neilson	y
hayden midgley	hayden midrley	y
kade morris	kade morris	y
daniel kisielecki	daniel kisielecki	y
dante healy	dante heaoy	y
emma sereda	emma sereda	y
arabella morgan	arabella morgan	y
georgia storey	georgia storey	y
mitchell mcintyre	mitchell mcintyre	y
william iannetti	william iannetti	y
cooper howe	cooper howe	y
naomi wiggins	naomi wiggins	y
ashleigh larkins	ashleigh larkins	y
leah 	leah 	y
benjamin jones	benjamin jones	y
kynan steele	kynan steeleg	y
madison penglase	madison penglzse	y
chloe dicker	chle dicker	y
felicity clark	felicity clark	y
kristen kremzer	kristen kremzer	y
william sedunary	william sedunary	y
alexander chimmalimmal	alexander chimmalimmal	y
matthew brodie	matthew brodie	y
robbie sandford	robbie sandford	y
maya welk	maya welk	y
timothy bricout	timothy brixout	y
wilson randall	wilson randall	y
sophie conaghty	sofia conaghty	y
campbell barker	campbell barker	y
genevieve vogels	genevieve vogels	y
chloe capone	chloe capone	y
madison 	madison 	y
jordan cox	jordan clx	y
brooke symond	brooke symomnd	y
brendan burlik	brendan burlik	y
luke faggotter	luke faggotter	y
joshua mcpherson	joshua mcphefson	y
montanna pinder	montanna pinder	y
jaggah murphy	jaggah murphy	y
hayley tsakiris	hayley tsakiris	y
keely cunningham	keely cunningham	y
harriet walker	harriet walker	y
timothy keane	timothy keane	y
barnaby lemon	barnaby lemon	y
luke johnson	luke johnosn	y
ellen leatherbarrow	ellen leatherbarrow	y
reece naylor	reece naylof	y
ethan whiteread	ethan whiteread	y
olivia weeding	olivia weeding	y
luke hildebrand	luke hildebrand	y
claire dickman	claire dickman	y
jaslyn williams	jaslyn williams	y
katelin cox	katelin cox	y
kyle pham	kyle pham	y
phillip cunningham	phillip cunningham	y
timothy edwards	timothy edwards	y
amaya hicks	amyaa hicks	y
joshua ramasundera	joshua ramasundera	y
georgia etzler	georgia etzler	y
toby cannell	toby cannell	y
alexandra robins	alexandra robns	y
lauren peisley	lauren peisley	y
gillian muddle	gillian muddle	y
ellen shurville	ellen shurviolle	y
patrick ramasundera	parick ramasundera	y
noah castle	noah castle	y
noah cole	noah cole	y
alana tranfa	alana tranfa	y
sarah martin	saraj martin	y
spyke james	spyke james	y
gracie hester	gracie hestrr	y
isabella nayda	isabella nayda	y
jessica fisher	jessia fisher	y
aidan buckhhiem	aidan buckhihem	y
mia saunders	mia saunders	y
jack frankcomb	jack frankcomb	y
zoe morris	zoe morrs	y
lauren creely	lauren creely	y
 warnock	 warnock	y
matthew sekhon	mattew sekhon	y
lucy lewis	lucie lewis	y
esme dickson	esme dixon	y
adam 	adam 	y
seamus mcalpine	seamus mcalpine	y
robert nagel	robert nagel	y
xavier leonard	xavier leonard	y
jacob proudlock	jacob proudlock	y
aleisha rigney	aleisha rigney	y
teileah de luca	teileah luca de	y
mitchell 	mitchell 	y
emma talbot	emma talbot	y
katelyn spouncer	katelyn spouncer	y
charlie saint	charlie saint	y
alexandra munyarryun	alexandra munyarryun	y
hannah malinovski	hannah malinovsji	y
liam corlett	lian corlett	y
emiily fraser	emiily frasepr	y
madeleine atkins	madeleine atkins	y
daniel piec	daniel piec	y
amelie onley	amelie onley	y
ethan gillam	ethan gillam	y
angus wileman	angus wileman	y
lucy mulye	lucy mulye	y
nemesia 	nemesia 	y
jacob dutschke	jacob dutschke	y
stephanie nenke	stephanie nenke	y
daniel durham	daniel durham	y
riley koursaris	ryley koursaris	y
ellouise stewart	ellouise stewart	y
ronan burgess	ronan burgoss	y
jasmine sweetman	jasmine sweetman	y
erin hughes	erin hughes	y
georgia moran	georgia moran	y
shona 	shona 	y
patrick mead	patrick mead	y
serena nilsson	serena nilsson	y
tayla beck	tayla beck	y
peter hunt	peter hunt	y
lily carney	lily carney	y
joel bradley	joel bradley	y
william moritz	william moritz	y
hannah thornton	hannah thornton	y
abbey smith	abbey smith	y
kobe greig	kobe greig	y
kai thiele	kai thiele	y
danny williams	danny williams	y
connor doust	connor doust	y
jack trull	jaxk trull	y
charles cowen	charles cowej	y
benjamin stieglitz	benjamin stieglitz	y
vianca d'costa	viajca d'costa	y
shantal harris	shantal hareis	y
joel tuohy	joel tuoht	y
tabitha schneider	tabitha schneider	y
amy alias	amy alizs	y
zoe binney	zoe binney	y
holly young	holly young	y
zachary modra	zachary modra	y
thomas conboy	thomlas conboy	y
thomas duncan	thomas duncan	y
xavier dale	xavker dale	y
daniel gentilcore	daniel gentilcore	y
kiana keyes	kiana keyes	y
thomas kapelis	thoma kapelis	y
ruby waye	ruby 	y
brock michelbach	brock michelbach	y
bailley rogers	bailley rogers	y
brooke potter	brooke potter	y
dillon langridge	dillon langridge	y
evan heisters	evan heisters	y
eliza luttrell	eliza luttrell	y
cameron elphinstone	camdron elphinstone	y
alisha bockman	alisha bockman	y
clement adlam	clement adlam	y
neneh stocks	neneh stocks	y
emiily condipodero	emiily condipodero	y
joel serra-esteva	joel serra-esteva	y
daniel cunningham	daniel cunningnam	y
kalli bottomley	kalli bottomley	y
sophie lyons	sophie lyons	y
jessica dromgold	jettie dromgold	y
jack sherriff	jack sherriff	y
angelica dempsey	angelica dempsey	y
olivia fadini	olkvia fadini	y
benjamin vinall	 vinall	y
casey doosjen	casey doosjen	y
sophie johnson	sophie johnston	y
charlotte ranyard	charlotte ranycrd	y
thomas carroll	thomas carroll	y
matthew gibbie	matthew gibbie	y
jaxson gaugler	jaxson gaugler	y
teileah smith	teileah smith	y
logan meissner	logan meissner	y
 margrie	 margrie	y
alana day	alana day	y
amber mitchell	amber mitchell	y
nicholas densley	nicholas denlsey	y
riley mitchell	riley mitchell	y
caitlin playford	caitlkn playford	y
lachlan pfitzner	lachlan pfitzner	y
 dolling	 dolling	y
georgia bartlett	georgia bartlett	y
blake brooker	blake brooker	y
bailey iannella	baily iannella	y
tom thorp	tom thprp	y
jessica hogan	jessica hogan	y
laura thomas	laura thomas	y
nicholas adams	nicholas adams	y
bailey branson	bailey branson	y
paul matters	paul matters	y
sebastian how	sebastian how	y
kydan rubenhold	kydan rubenhold	y
tahlia dixey	tahlia dixey	y
abbey modra	abbey modra	y
makayla hudson	makayla hudson	y
breana edwards	breana edwards	y
taylah gloede	tayla gloede	y
george brereton	george brereton	y
daniel denny	daniel denny	y
isabel noel	isabel noel	y
lachlan robinson	lachlan robinson	y
thomas sing	thomas sing	y
scott buckley	scott buckley	y
monique hope	monique hope	y
blade webber	blade webbet	y
hannah neander	hannah neander	y
lukas crossin	lukas crossin	y
morgan hollens	morgpan hollens	y
brooke mansingh	brooke mansinvh	y
timothy forbes	timoty forbes	y
laura mays	laura mayw	y
nicholas lange	nicholas lange	y
sarah coyle	sarah coyle	y
nicholas walters	nicholas wabters	y
chelsea le	chelsea le	y
emiily thompson	emiily thompson	y
mitchell webb	mitchell webb	y
jesse gabriel	jesse gabriel	y
lilly morris-finlay	lilly morrisnfinlay	y
 jones	 jones	y
isabella duggan	isabella duggan	y
harrison cotter	harrison cotter	y
jayme latimer	jayme latimer	y
zane amoueigokanie	zane amoueigokanie	y
tahlia guard	tahla guard	y
mitchell comelli	mitchell comelli	y
brendan taylor	brendan taylor	y
tanyshah hayes	tanyshah hayes	y
jackson thacker	jackson thacker	y
mitchell tolfts	mitchell tolfts	y
naomi arnold	naomi arnold	y
nathan morgan	nathan morgan	y
madelyn bryan	madelyn brian	y
sarah ellis	sarah ellis	y
kaitlin austin	kaitlin austin	y
connor steed	conner steed	y
rosie cook	rosie cook	y
leo braunack	leo braurack	y
samuel kozuszko	samuel kozuszko	y
kiana woodrow	kianw woodrow	y
troy thorpe	troy thorpe	y
emiily terry	emiily terry	y
charlotte whitewood	charotte whitewood	y
rhys hurcum	rhys hurcum	y
jacob thomson	jacob thomson	y
sophie heinrich	sophir heinrich	y
william koch	william koc	y
lachlan herriman	lachlan herriman	y
brooklyn hassan	brooklyn hassan	y
bailey mclean	bailey mclean	y
pakita skrtic	pakita skrtic	y
riley robotham	riley robotham	y
 couzner	 couzner	y
amy chisholm	amy chishsolm	y
jasmine 	jasmine 	y
shona greaves	shona greaves	y
arren lewis	arren lewis	y
lucas pybus	lucas pybus	y
william colmer	william colmer	y
hannah davis	hannah davis	y
joshua etschmann	joshua etschmann	y
benjamin bradford	benjamin bradford	y
sebastian ransley	sebasyian ransley	y
sophie mazzarino	sophie mazzarino	y
rebecca dart	rebecca dart	y
tiffany riley	tiffany rile	y
arki walker	arki walkee	y
natalia moeljo	natalia moeljo	y
michael norton	michael norton	y
amelia smith	amelia smith	y
madison rice	madison rice	y
 randall	 randall	y
mitchell carbone	mitchell carone	y
charlie james	charlie james	y
jasmyn mitchell	jasmyn mitchell	y
jake mayberry	jakd mayberry	y
jenna wright	jenna wrihgt	y
kade dohnt	kade dohnt	y
charlie dunstall	charfie dunstall	y
alexander ownsworth	 ownsworth	y
 gallagher	 gallagher	y
william sim	william sim	y
lara holzer	lara holzer	y
isabella patel	isabella patel	y
trevor tolley	trevor tolley	y
robin 	robin 	y
tayla hand	tayla hand	y
cooper johns	cooper jogns	y
zac mansfield	zac mansvield	y
samantha blackeby	sam blackeby	y
caleb atherton	caleb atherton	y
tayah herrmann	tayah herrmann	y
jasmine rowe	jasmine row	y
joshua foster	joshua foster	y
lauren browning	lauren browxning	y
joshua bigham	joshua bigham	y
campbell lenger	campbell lenger	y
chelsea long	chelsea long	y
emiily mills	emiily mills	y
william ferguson	william ferguson	y
heath giannoitis	heath giannoutis	y
amelia blandis	amelia blandis	y
william hine	william hine	y
kyle jarrett	kyle jarrett	y
seanna schirmer	seanna schirmer	y
thomas davies	thomas davies	y
tyler childs	tyler childs	y
holly davies	holly davies	y
amber graham	amber graham	y
lauren usher	lauren usher	y
elizabeth spencer	elizabrth spencer	y
emiily ryan	emiily ryan	y
madeline coffey	madeline coffy	y
caresse saunders	caresse saunders	y
holly urso	hollie urso	y
sarah brothers	sarah brothers	y
christopher arnold	christopher arnold	y
danny marshall	danny marshall	y
malakai hemmingsen	malakai hemmingsen	y
luke bills	luke bills	y
nicholas lant	nicholas lant	y
madeleine till	madeleine till	y
barnaby connor	barnaby conor	y
tara bryson	tara bryson	y
nicholas tran	nicholas tran	y
christian young	christian young	y
hugh warin	hugh warih	y
adam lowe	adam lowe	y
madeline ducker	madelin ducker	y
jessica doherty	jessie doherty	y
harrison lowe	harrison lowe	y
lara mcpherson	lars mcpherson	y
cameron seaton	cameron haseloff	y
sara gaunt	sars gaunt	y
tanyshah brook	tanyshah brook	y
caitlin roberts	caitlin roberts	y
jessica mitchell	jessica mitchevl	y
isabella decaux	isabella decaux	y
ethan priest	ethan priest	y
taliah jackson	taliah jackson	y
nathan kellett	nathan kellett	y
meagan thompson	meagan thompson	y
isabella williams	isabella williwams	y
giuliana kowald	giuliana kowalt	y
teagan gibbons	teagan gibbons	y
william schubert	william schubert	y
jasper duke	jasper duke	y
connor dale	connor dale	y
polly mckenzie-mcharg	polly mckenzie-mcharg	y
oliver wandtke	oliver wandtke	y
lachlan mayo	lachlan mayo	y
joshua twerd	joshua tweed	y
eleni symes	eleni symes	y
jacob asa	jacob asa	y
stelio stewart	stelio stewart	y
oscar bagshaw	oscar bagshaw	y
emma mellar	emm mellar	y
dylan bailey	dylan bailey	y
madeline galic	madeline galic	y
connor giles	conner giles	y
zachary smith	zakariah smith	y
tara rozynski	tara rozynski	y
lauren brown	lauren brown	y
kiara wise	kiara wise	y
evan mack	evan mack	y
danika spence	danika spence	y
thomas atkinson	thomas atkinson	y
xavier lovell	xavier lovell	y
jacob phillips	jacob phillips	y
lily carter	lily carter	y
thomas livingston	thomas livingston	y
evan valeri	evan valeri	y
blake richmond	blake richmond	y
rourke dear	rourke dear	y
christian hill	christian hill	y
ebony yates	ebony yates	y
james bond	james bond	y
emiily wigmore	emiliy wigmore	y
christopher weller	christopher welder	y
emiily leverton	emiily leverton	y
connor piotto	connor piotto	y
samir d'ettorre	samir d'ettorre	y
blake morgan	blske morgan	y
alexandra fulton	alexawdra fulton	y
micah smith	micah smith	y
gianni 	giani 	y
charlotte 	charlotte 	y
brodee matto	brodee matto	y
hayley tulloch	hayley tulooch	y
jaden hackett	jaden hackett	y
harrison newland	harrison newland	y
sophie farrington	sophie farrington	y
nathan elliot	nathan elliot	y
oliver coulter	oliver coulter	y
chloe reid	chloe reid	y
kate duniam	kate duniame	y
tara sibly	tara sibly	y
tyler lengs	tyler lengs	y
matthew astor	matthew astor	y
harry steers	harry steers	y
william watson	william watsoh	y
toby elliott	tobu elliott	y
jennifer brown	jenna brown	y
courtney burgess	courtney burgess	y
jessica duncombe	jesica duncombe	y
michael gregory	michael 	y
matthew 	matthew 	y
anna nelson	anna nelson	y
michael rosenzweig	michael rosenzweig	y
abbey wagner	abbey wagner	y
dean macdonald	deam macdonald	y
jayden stratos	jayden stratos	y
brodie franks	brodie franks	y
tahlia saxton	tahlai saxton	y
emmet mitchell	emmet micheal	y
samuel elliott	samuel elliot	y
amy doe	amy doe	y
charlotte hoare	charltte hoare	y
zac summers	zac summers	y
reuben cordes	reuiben cordes	y
teagan ferguson	teagan ferguson	y
madeline issell	madeline issell	y
joel simkins	joel simkins	y
zali heikkinen	zali heikkinen	y
georgia vivian	georgia vivian	y
ethan roy	ethan roe	y
isabella douglas	isabella douglas	y
charlotte slaap	charlotte slaap	y
diamond miller	diamond miller	y
kyle box	kyle box	y
clodagh mattner	clodagh mattner	y
lani whittaker	lani whittaker	y
declen spencer	declen spencer	y
christian rivers	christian rivers	y
julia watherston	julia watherston	y
blakeston zaporowski	blakeston zaporowski	y
yasmin pearce	yasmin pearce	y
joshua sparks	joshua sparks	y
sachin marshall	sachin marshlal	y
sebastian holman	sebastian holmsn	y
marley jackson	marley jacjson	y
timothy quinn	timothy quinn	y
sylvie clarke	sylvie clarke	y
samuel cummings	samuel cummings	y
emiily bini	emiily bini	y
fergus sands	fergus sanss	y
kirrah matthews	kirra matthews	y
braedon davis	braedon davis	y
luke donnelly	luke donnelly	y
seth mcculloch	seth mcculloch	y
ellorah artis	ellorah artis	y
niamh pauli	niamh pauli	y
ka mayne	ka mayne	y
ruby mccrum	ruby mccrum	y
tahlia blieschke	tahlia blieschke	y
oliver mansfield	oliver mansfield	y
madison buenviaje	madison buenviaje	y
lachlan danylycha	lachlan danylycha	y
liam moy	liam moy	y
ashlee girardi	ashlee girardi	y
alicia bennett	alicia bennett	y
riley mundy	riley mundy	y
meg mcmillan	meg mcmillan	y
bianca barker	bianca barker	y
tyler bruce	tyler bruce	y
connor herlindah	connor herlindah	y
zali macrury	zali macrury	y
samantha dunstan	samanta dunstan	y
tansy scorgie	tansy scorgie	y
demie cripps	demie cripps	y
joshua falko	joshua faklo	y
phoebe thurgood	phoebe thurgood	y
adam burke	adam burke	y
xavier findlay	xavier findlay	y
brigitte delfabbro	brigityte delfabbro	y
emiily tanner	emiily tanner	y
dante sutcliffe	dant sutcliffe	y
lara birchby	lara birchby	y
lexie heath	lexie heath	y
bella mcgrath	bella mcgrath	y
corie christian	corie christian	y
james crawford	james crawford	y
seth roach	set roach	y
jake beames	jake beames	y
alexander hills	alexsnder hills	y
madison hill	madison hill	y
marco orszaczky	marco orszaczky	y
joshua rodman	joshua rodman	y
 moffatt	 moffatt	y
sophie harries	sophie harries	y
hannah saraceni	hannah saracwni	y
dylan akers	dylan akers	y
kaitlyn hills	kaitlyn hils	y
matthew coley	matthew coley	y
jacinta moritz	jacinta moritz	y
mason brown	mason brown	y
breana manning	breana manning	y
annabelle wood	annabelle wood	y
gracie de leeuw	gracie de leduw	y
katie kidd	katie kifd	y
isabelle smith	isabelle smith	y
adam good	adam good	y
philip smith	philp smith	y
asha wiseman	asha wiseian	y
aloysius strudwick	aloysius strudwaick	y
nathan mckee	nathan mckee	y
thomas milde	thomas milde	y
jordan seden	leah seden	y
bailey cross	bailey cross	y
jed saward	jed saward	y
beth carpenter	beth carpenter	y
erin tetzsch	erin tetsch	y
kazuki tierney	kazuki tierney	y
jack taylor	jack taylor	y
ka lethbridge	ka lethbridge	y
 duxson	 duxson	y
tiarna mooney	tiarna mooney	y
 kalnins	 kalnins	y
harry beck	harry beck	y
caitlin derighetti	caitlin derighetti	y
rebecca byrnes	rebecca thomas	y
paris viney	paris viney	y
jenna flynn	jenna flynn	y
kelsey prior	kelsey prior	y
matilda lockwood	matilda lockwood	y
timothy marshall	timothy marshall	y
madeline tregenza	madeline tregenza	y
jacqueline drysdale	jacqueline drysdale	y
ayden muemchoem	ayden muemchoem	y
noah edwards	noah edwards	y
benjamin stevens	benjamin stevejs	y
eliza hutchings	eliza hutchings	y
ryleh freer	ryleh freer	y
kirra hudson	kirra hudson	y
james langley	giuseppi langley	y
abbey mclean	abbey mclean	y
joel mcmahon	joel mcmahon	y
ethan egerton	ethan 	y
tyler little	tyler little	y
nikki wilson	nikki wilson	y
jack keser	jack keser	y
megan prisk	megan prisk	y
tarnee austen	tarene austen	y
 green	 green	y
gabrielle mason	gabrielle mason	y
ella lane	ella lane	y
sebastian benda	sebastian benda	y
bertie leditschke	bertie leditschke	y
toby brown	toby brown	y
lachlan urvet	lachlan urvet	y
alexandra hunt	alexandra hunt	y
macey shears	macey shears	y
noah aspinall	noah aspinall	y
joshua elias	joshua elias	y
nemesia summers	nemesia summers	y
braedon kendall	braedon kennall	y
lauren gloede	lauren gloede	y
joshua warren	joshua warrun	y
travis gregory	travis gregoru	y
 hasanica	 hasanica	y
katie blood	katie 	y
stephanie markham	stefanie markham	y
tayah 	tayah 	y
leo petersen	leo peteesen	y
skye hope	skye hope	y
miller brydon	miller brydon	y
mikaela humphries	mikadla humphries	y
lushia just	lushia just	y
trevor winston	trevor winstn	y
james robinson	james robinson	y
finlay king	finlay king	y
madalyn beal	madalyn beal	y
sam whitlock	 whitlock	y
emiily smialek	emiiky smialek	y
alaiyah conley	alaiyah conley	y
caleb baker	caleb baker	y
olivia barsznica	olivia barsznica	y
chelsie staines	chelsie staknes	y
rachel pfeiffer	rachel pfeiffer	y
alexandra murphy	alexanrra murphy	y
kaitlyn flavel	kaitlyn flavel	y
samantha van mook	samantha van qook	y
tyler hosch	tyler hosch	y
casey barwick	casey barwick	y
amber smets	amber smets	y
 badari	 badari	y
nicholas bissicks	nicholas bissicks	y
tyron qiao	tyrno qiao	y
rosie faber	rosie faber	y
charlotte cornelius	charlotte cornelius	y
jairus cobbin	jairus cobbin	y
 reed	 reed	y
chloe tam	chooe tam	y
deakin geer	deakin 	y
april bright-honu	april bright-honu	y
jordan wyman	jordan wyman	y
emiily croll	emiily croll	y
sophie grosser	sophie grosser	y
sarah roupas	sarah roupas	y
charlotte johnson	charlotte johnson	y
breeanne pajer	breeanne pajer	y
lachlan brougham	lachlsn brougham	y
larissa jeffree	larisa jeffree	y
brooklyn lim	brooklyn lim	y
 johnson	 johnson	y
kirra mcarthur	kirra mcarthur	y
shanaye parletto	shanaye parleyto	y
thomas smale	thomas smale	y
louise schmucker	louise schmucker	y
adam thompson	adam thompson	y
lachlan moles	lachlan mooes	y
cheree cvorkov	cheree cvorkov	y
sophie allen	sophie allen	y
jasmine sincock	jasmine sincock	y
joel wilson	 wilson	y
blakeston sedlacek	blakeston sedlacek	y
kyle doyle	kyle doyie	y
harry cooper	harry cooper	y
molly collins	molly collinqs	y
sara-louise whitlock	sara-louise whitlock	y
ellie simone	ellie simond	y
bailey abbott	bailey abbott	y
jack robinson	jack robinsoj	y
thomas penklis	thomas pejklis	y
nasyah dunn	nasyah dunn	y
karissa saunderson	karissa saunderson	y
mia higginson	mia higginson	y
emiily sinclair	emiily sinclair	y
michael haywood	michael haywood	y
zachary demorgan	zachary demorgan	y
liam miller	liam milhler	y
lily hollows	lily hollows	y
lily erwin	lily erwin	y
chelsea ottomers	chelsea ottomers	y
katelyn pellegrini	katelyn pellegrini	y
kelsey romeo	kelsey romev	y
timothy angliss	timothy angiss	y
bianca shillingford	bianca shillingford	y
lukas clapp	lukas clapp	y
rebecca ukleja	rebecca ukleja	y
mitchell taylor	mitchell tayloe	y
lara peterson	lara 	y
emiily decaux	emiiy decaux	y
charlotte mccarthy	charltte mccarthy	y
isabella gilmour	isabeola gilmour	y
ryan oliphamt	ryan oliphamt	y
james taylor	james taylor	y
stephanie clifford	stephanie clifford	y
lucy murray	lucy murray	y
 medley	 medley	y
olivia cooper	olivia cooper	y
danielle mickan	danielle mickfan	y
ben cooper	ben cooper	y
montana ganly	montana ganly	y
sean neale	sean neale	y
michael kernan	michael kernan	y
lukas hunt	lukas hunt	y
alana nunn	alama nunn	y
caleb todd	caleb todd	y
matthew jones	matthew jones	y
jessica mitchell	jessica jones	y
james graney	james graney	y
hannah tann	hannab tann	y
 elsworthy	 elsworthy	y
barnaby macdonald	barnaby macdonald	y
jamie apap	jamei apap	y
noah crisp	noah crisp	y
 muller	 muller	y
lilly prell	lilly prell	y
tara morrow	tara morrow	y
jamie nurton	ruby nurton	y
irene higgins	irene higgins	y
kyle maljevac	kyle maljevac	y
christina zois	christina zos	y
julia ling	julia ling	y
emiily abbott	emiily abbott	y
jordan 	jordyn 	y
isabelle leathbridge	isabelle leathbridge	y
niamh 	niamh 	y
maddison cock	maddison cock	y
sophie tobias	sophie tobias	y
eliza gantley	eliza ganley	y
lachlan cocca	lachlan cocca	y
 harris	 harris	y
william ola	william ola	y
benjamin tunbridge	benjamin tunbridge	y
eva ward	eva ward	y
 mooney	 mooney	y
riley zanker	riley zanker	y
lachlan kantilaftas	lachlan kantilaftas	y
desi poyser	desi poyse	y
 edwards	 edwards	y
sean bittisnich	sean bittisnich	y
lara houltby	lraa houltby	y
ella sanchez	ella sanchez	y
isabella byrne	isabella byrne	y
xanthe marshman	xanthe marshman	y
aaron ritchie	aaron ritchie	y
nicholas mclaren	nicholas mclsren	y
emiily bush	emiily bush	y
adam hage	adam hage	y
joshua bartsch	joshua bartsch	y
kyra jarvis	kyra jarvis	y
sophie slisher	sophie slisher	y
mitchell sindicic	mitchell sindicic	y
emiily haskett	emiily haskett	y
emiily breckenridge	emiily breckenridge	y
joshua myatt	joshua myatt	y
aleesha sutcliffe	aleesha sutcsiffe	y
amy zammit	amy zammit	y
tansy gill	tansy gill	y
mitchell randall	 randall	y
shanaye lecamwasam	shanaye lecamwasam	y
isabel cates	isabel cates	y
rebecca harbers	rebecca harbers	y
daniel edmonds	daniel edmonds	y
claudia parry	claudia parry	y
scott tatarelli	scott 	y
jaime wheatley	jaime wheatley	y
chelsea 	chelsea 	y
abbey schreuder	abbey schreuder	y
barkly smith	barkly smith	y
tara cutting	tara cutting	y
connor 	connor 	y
chelsea bonfiglio	chelsea bonfiglio	y
teagan hull	teagan hull	y
seth de la bere	seth de la bere	y
latham suhanek	latham suhanek	y
dante charles	dante charles	y
sam kong	sam kong	y
matthew duff	matthew duff	y
joe blair	joe blair	y
owen lahey	owen lahey	y
gabriella phelps	gabriella phelps	y
james oliver	james oliver	y
kyle bosanko	kyoe bosanko	y
annabel cooper	annbel cooper	y
eleni phillips	eleni phillips	y
amber mckenzie	amber mckelzie	y
james johnstone	james johnstone	y
samuel giliam	samuel giliam	y
alaiyah wiese	alaiyah wiese	y
chloe kennare	chloe kennare	y
deakin perry	deamin perry	y
lachlan pott	lachlan pott	y
yana jarman	yana jarman	y
thomas hanley	thomas hanley	y
emiily mac ris	emiily mac fis	y
henry kennedy	henry kennedy	y
chloe branford	chloe branford	y
joshua gardenier	joshua gardenier	y
noah o'connell	noah o'connell	y
madison brown	madison brown	y
mitchell griffith	mitchell griffith	y
tahlia leeson	tahlia leeson	y
arren button	arren button	y
elly johns	elly johns	y
thomas cleary	 cleary	y
elise millican	elise millican	y
shane hayward	shane hayward	y
lucy potts	lucy potts	y
alexandra muhammed	alexandra muhammed	y
ella grix	ella grix	y
dante cavallo	dante cavallo	y
isabella dyer	isabella deyr	y
cooper pavlich	cooper pavlich	y
thomas eyles	thomas eyles	y
william ochi	william ochi	y
emiily o'loughlin	emiily o'loughlin	y
nicholas robertson	nicholas robertson	y
amy de filippo	amy de fiwlippo	y
